chargender,authgender,date,characters,speaking,agent,mod,patient,poss,total
u,u,1922,2599,18556,11571,949,3111,2650,18281
u,u,1923,12857,311720,63209,4176,15258,13303,95946
u,u,1924,7955,140724,32625,2372,8275,6481,49753
u,u,1925,9217,214144,43310,3228,11367,8702,66607
u,u,1926,10263,186552,39112,3008,10310,8401,60831
u,u,1927,9478,140638,34821,2808,9513,6800,53942
u,u,1928,11427,189599,48351,3494,12749,9524,74118
u,u,1929,14951,278456,63553,4518,15851,12939,96861
u,u,1930,13008,326167,72716,5120,16348,15221,109405
u,u,1931,11678,228463,54028,3633,12574,11864,82099
u,u,1932,9625,227836,47894,2947,10859,10234,71934
u,u,1933,7455,124017,31363,2446,7635,6477,47921
u,u,1934,8321,224721,37729,2890,9852,8158,58629
u,u,1935,7896,167415,41279,3054,8820,9038,62191
u,u,1936,10266,172442,41719,3158,9261,9296,63434
u,u,1937,8444,167813,39889,3231,8988,7766,59874
u,u,1938,8316,125887,40097,2899,8759,7857,59612
u,u,1939,7563,191423,37385,2689,8262,7935,56271
u,u,1940,7635,173100,46480,3161,10302,8731,68674
u,u,1941,7341,125694,34151,2423,8336,8057,52967
u,u,1942,7664,124701,34970,2571,7591,7150,52282
u,u,1943,9346,160104,41249,2753,9033,7857,60892
u,u,1944,7561,135211,34529,2483,7485,7810,52307
u,u,1945,9089,212232,47388,3254,10016,8980,69638
u,u,1946,14732,329713,67719,4921,15049,13406,101095
u,u,1947,12111,242541,63045,4437,13683,12256,93421
u,u,1948,12746,262707,62478,4471,14219,11830,92998
u,u,1949,12529,217099,58157,4062,12550,10706,85475
u,u,1950,15785,405381,89004,5777,18654,17148,130583
u,u,1951,11190,224962,59078,4169,12654,11830,87731
u,u,1952,12946,342394,76611,5157,16583,15454,113805
u,u,1953,12827,278977,67992,4599,14961,14123,101675
u,u,1954,11783,312432,81351,4959,16063,15461,117834
u,u,1955,15469,367460,81316,5663,17708,16567,121254
u,u,1956,13853,327346,78161,5293,16703,15933,116090
u,u,1957,13898,331968,80131,5646,17225,15947,118949
u,u,1958,13906,322966,91899,5924,18097,17746,133666
u,u,1959,15002,311292,76087,4983,16783,15471,113324
u,u,1960,16870,385607,96344,5996,19928,19380,141648
u,u,1961,19218,368060,103669,7520,21947,21848,154984
u,u,1962,19750,409978,108099,6983,24459,20596,160137
u,u,1963,18165,387934,98819,6510,20621,19172,145122
u,u,1964,18618,342323,97442,6596,20363,19118,143519
u,u,1965,20442,348042,103898,7110,22377,20970,154355
u,u,1966,20326,412325,109782,7302,23058,23312,163454
u,u,1967,25734,401736,116912,8291,27821,24116,177140
u,u,1968,26100,408638,128385,9138,28944,26109,192576
u,u,1969,23949,400656,109676,8205,24009,22672,164562
u,u,1970,25512,462674,125002,8900,27566,25109,186577
u,u,1971,18038,387241,95761,6332,20736,20595,143424
u,u,1972,17302,266205,75867,5619,16474,16343,114303
u,u,1973,17604,292284,86409,6192,18266,18157,129024
u,u,1974,15277,275256,75313,5367,15947,15033,111660
u,u,1975,19795,386738,99270,7178,21262,19624,147334
u,u,1976,20593,319350,91591,6767,19825,19350,137533
u,u,1977,20076,320114,98034,7504,21110,20719,147367
u,u,1978,19375,404400,105745,7119,22263,23264,158391
u,u,1979,19820,396061,105909,7069,21740,21793,156511
u,u,1980,18643,324241,100644,6831,20226,20742,148443
u,u,1981,21203,367997,105480,7143,21332,24200,158155
u,u,1982,21199,406399,108371,7537,22448,22898,161254
u,u,1983,24297,439564,123558,8095,24671,26100,182424
u,u,1984,19782,388432,101223,6544,23405,20132,151304
u,u,1985,21780,369750,117414,8019,24244,26386,176063
u,u,1986,20511,386341,112495,7640,22524,23241,165900
u,u,1987,20373,325575,106844,7394,22062,23559,159859
u,u,1988,22255,357621,114869,7940,23251,24518,170578
u,u,1989,23878,414330,131370,9300,27716,28279,196665
u,u,1990,25943,485092,141306,10115,28790,31430,211641
u,u,1991,25507,436061,136192,9268,28089,29388,202937
u,u,1992,26336,511855,145387,10499,30266,32656,218808
u,u,1993,25926,396649,136256,9792,27862,31427,205337
u,u,1994,24447,387507,125151,9302,26641,28707,189801
u,u,1995,21819,368827,113461,8063,24103,26297,171924
u,u,1996,23157,374546,111638,7635,23634,26609,169516
u,u,1997,21982,419628,112988,8087,22697,24382,168154
u,u,1998,21546,376982,108149,7979,22895,26453,165476
u,u,1999,20455,346713,112198,7605,22863,27108,169774
u,u,2000,19465,308937,100408,6882,20367,22830,150487
u,u,2001,18737,315167,104217,7124,21253,23721,156315
u,u,2002,20421,316713,98703,6815,18989,22696,147203
u,u,2003,17575,331052,101840,6855,20133,22066,150894
u,u,2004,20225,319394,106672,7818,22743,25236,162469
u,u,2005,20800,345417,118153,8180,23599,26962,176894
u,u,2006,20214,363576,128671,8461,24548,29158,190838
u,u,2007,21367,373658,123653,7905,24676,27566,183800
u,u,2008,12064,167654,66272,4612,12982,14056,97922
u,u,2009,4823,51719,22645,1653,4535,5056,33889
u,u,2010,1075,10242,4843,347,1026,836,7052
u,u,2011,65,485,63,2,16,3,84
u,u,2012,0,0,0,0,0,0,0
u,u,2013,0,0,0,0,0,0,0
u,u,2014,0,0,0,0,0,0,0
u,f,1922,2,0,8,2,1,1,12
u,f,1923,1178,22898,5816,499,1427,1266,9008
u,f,1924,1656,31124,8003,638,1891,1900,12432
u,f,1925,1431,26311,8306,698,1844,1966,12814
u,f,1926,1675,30465,7687,629,1946,1769,12031
u,f,1927,1969,35830,9521,925,2463,2523,15432
u,f,1928,2217,42658,11129,944,2721,2558,17352
u,f,1929,2504,57356,16377,1372,3287,3239,24275
u,f,1930,1925,40675,13227,1064,2983,3027,20301
u,f,1931,2389,49673,13181,1022,3247,3262,20712
u,f,1932,1685,27804,7675,664,1762,2003,12104
u,f,1933,1649,31151,8858,647,1797,2050,13352
u,f,1934,2298,32750,9673,893,2403,2168,15137
u,f,1935,2820,54715,15610,1262,3528,3299,23699
u,f,1936,2735,48486,12526,960,2897,2956,19339
u,f,1937,2505,68277,16948,1295,3449,3621,25313
u,f,1938,2466,37970,12549,907,2845,2824,19125
u,f,1939,1701,33569,8852,679,1944,1959,13434
u,f,1940,1578,47663,9854,657,2087,1999,14597
u,f,1941,2105,36941,10572,742,2184,2325,15823
u,f,1942,2003,37066,10236,837,2497,2351,15921
u,f,1943,2049,54971,12725,784,2717,2929,19155
u,f,1944,2215,34124,9190,766,2086,2183,14225
u,f,1945,2171,65985,16108,1088,3166,3240,23602
u,f,1946,3061,54154,14526,1127,3077,2880,21610
u,f,1947,2353,36645,11152,862,2389,2389,16792
u,f,1948,2167,44746,12944,933,2716,2486,19079
u,f,1949,2263,43319,12645,944,2517,2517,18623
u,f,1950,2653,47380,14010,1102,2803,2783,20698
u,f,1951,2723,54965,15241,1119,3134,2891,22385
u,f,1952,3122,59550,17464,1327,4024,4242,27057
u,f,1953,2630,42615,13135,990,2856,3023,20004
u,f,1954,2933,57155,16188,1206,3485,3486,24365
u,f,1955,2307,39631,11126,804,2354,2218,16502
u,f,1956,2584,55444,17625,1344,3379,3383,25731
u,f,1957,2437,50854,17130,1283,3444,3385,25242
u,f,1958,2606,44364,13880,1035,2940,3005,20860
u,f,1959,2393,64159,17180,1143,3270,3602,25195
u,f,1960,2861,42878,13324,1035,3021,2882,20262
u,f,1961,2767,59594,21224,1475,4303,4121,31123
u,f,1962,2757,39990,14017,967,3201,2643,20828
u,f,1963,2521,44067,14203,977,2840,3536,21556
u,f,1964,2592,36122,15145,1173,2971,3535,22824
u,f,1965,2664,57460,16140,1063,3211,3370,23784
u,f,1966,2278,38347,14229,1006,2859,3132,21226
u,f,1967,2436,34774,11880,877,2494,2239,17490
u,f,1968,2656,49599,15211,983,3055,3239,22488
u,f,1969,2503,40888,14292,891,2645,2933,20761
u,f,1970,3631,48937,14467,1180,3279,3357,22283
u,f,1971,1787,22046,8002,630,1664,1946,12242
u,f,1972,2009,38898,9578,728,2038,1938,14282
u,f,1973,2583,36942,13786,1046,2896,3399,21127
u,f,1974,2808,49826,17471,1209,3220,4196,26096
u,f,1975,2782,62753,15307,981,2930,3433,22651
u,f,1976,2796,65655,20218,1320,3792,4320,29650
u,f,1977,2535,56238,18802,1219,3308,3802,27131
u,f,1978,2893,58642,19251,1200,3591,4775,28817
u,f,1979,3735,88934,31272,1695,5643,7439,46049
u,f,1980,3746,63920,21547,1493,4260,5160,32460
u,f,1981,2936,46228,16234,1084,3259,4034,24611
u,f,1982,3227,79915,26223,1730,4801,5992,38746
u,f,1983,2731,48795,16449,1067,3137,3626,24279
u,f,1984,3192,62491,19407,1266,3714,4613,29000
u,f,1985,3577,81080,24988,1695,4938,5927,37548
u,f,1986,3317,61374,19947,1252,3637,4517,29353
u,f,1987,3948,90000,26096,1577,4823,6189,38685
u,f,1988,5168,97490,38513,2431,6961,8983,56888
u,f,1989,4354,121112,30003,1696,5478,6924,44101
u,f,1990,4659,88938,28314,2119,5416,6678,42527
u,f,1991,4974,87993,30108,2286,5934,6990,45318
u,f,1992,5348,122556,38171,2329,7171,9823,57494
u,f,1993,5021,111403,35841,2434,6090,8663,53028
u,f,1994,5968,147230,47547,2700,8026,11338,69611
u,f,1995,5608,86640,28634,1988,6042,7062,43726
u,f,1996,6616,111440,33497,2230,6713,8209,50649
u,f,1997,6326,116685,34155,2155,6147,8623,51080
u,f,1998,5029,96839,30233,1855,5695,7245,45028
u,f,1999,5695,76858,29989,2118,6212,7611,45930
u,f,2000,5552,87835,33051,2268,6367,7919,49605
u,f,2001,5513,113130,31767,2181,6522,7918,48388
u,f,2002,5416,78918,27674,1917,5742,6553,41886
u,f,2003,5859,108415,38529,2598,7089,8688,56904
u,f,2004,5390,100801,35397,2505,6373,7991,52266
u,f,2005,5769,103778,34109,2363,6427,7699,50598
u,f,2006,5730,108928,41539,2725,7452,9019,60735
u,f,2007,5989,64306,29736,2241,6078,6762,44817
u,f,2008,5302,66116,33034,2350,6683,8222,50289
u,f,2009,2942,34810,20395,1235,3837,4592,30059
u,f,2010,12,0,67,3,12,6,88
u,f,2011,0,0,0,0,0,0,0
u,f,2012,0,0,0,0,0,0,0
u,f,2013,0,0,0,0,0,0,0
u,f,2014,0,0,0,0,0,0,0
u,m,1922,471,9290,1681,89,327,326,2423
u,m,1923,6190,120110,30004,2223,7335,6632,46194
u,m,1924,6118,101554,23070,1722,5570,5428,35790
u,m,1925,6050,128974,29570,2176,6663,6487,44896
u,m,1926,6039,197354,29886,2277,6698,6103,44964
u,m,1927,7317,174517,32499,2406,8239,7370,50514
u,m,1928,7424,128595,32528,2428,7964,6936,49856
u,m,1929,7924,116824,31329,2368,8024,6375,48096
u,m,1930,7935,154744,36327,2583,8425,7619,54954
u,m,1931,5288,127707,27798,1995,6511,5783,42087
u,m,1932,5760,116250,29286,1991,6525,6264,44066
u,m,1933,8120,222309,40107,2989,8608,7670,59374
u,m,1934,6739,200902,39713,2687,8742,8400,59542
u,m,1935,8654,182762,49637,3519,10440,10397,73993
u,m,1936,5589,80335,23732,1865,5659,5645,36901
u,m,1937,6997,110207,28221,2139,6490,5949,42799
u,m,1938,5696,100838,28066,2072,5956,5730,41824
u,m,1939,5021,112271,24704,1767,5401,5305,37177
u,m,1940,5561,114861,30690,2149,6408,6378,45625
u,m,1941,5314,100555,25535,1834,5637,5845,38851
u,m,1942,6030,99716,30943,2019,6488,5921,45371
u,m,1943,6400,118696,29389,2081,6462,4953,42885
u,m,1944,5211,75391,21148,1569,4856,4173,31746
u,m,1945,5984,110966,29057,1968,5908,5025,41958
u,m,1946,8063,166818,41151,2703,7903,8447,60204
u,m,1947,9782,171198,45541,3317,9721,9354,67933
u,m,1948,6516,159864,34644,2318,6926,7224,51112
u,m,1949,7339,132074,33092,2213,6698,6844,48847
u,m,1950,9204,234856,56275,3134,10595,11009,81013
u,m,1951,8565,195478,48279,3260,9662,8636,69837
u,m,1952,8641,168627,46076,3256,9587,9849,68768
u,m,1953,8306,172124,45586,3089,9360,8784,66819
u,m,1954,8533,143720,41403,2692,7988,7699,59782
u,m,1955,9845,184575,54938,3737,10637,10054,79366
u,m,1956,9343,155029,43953,3058,9073,7932,64016
u,m,1957,7905,148512,39527,2656,7685,7805,57673
u,m,1958,8079,143240,44374,3382,9251,8493,65500
u,m,1959,9835,226676,56884,3336,10618,10383,81221
u,m,1960,8486,156683,44736,2817,8690,8440,64683
u,m,1961,10410,181530,53324,3405,10242,10427,77398
u,m,1962,8360,136711,42699,2674,8333,7767,61473
u,m,1963,9418,139613,47579,3188,9535,9247,69549
u,m,1964,10328,184931,54502,3774,10858,10560,79694
u,m,1965,11208,201469,59051,3722,11632,11186,85591
u,m,1966,11697,193320,63383,3934,11843,12894,92054
u,m,1967,10692,182293,56430,3595,11313,11687,83025
u,m,1968,12675,189480,64968,4129,13043,12837,94977
u,m,1969,12853,200647,56333,3970,11507,10627,82437
u,m,1970,11498,182855,61089,3909,11283,12472,88753
u,m,1971,10220,154466,47807,3334,9490,9505,70136
u,m,1972,8671,146831,45738,3009,8806,9604,67157
u,m,1973,9707,166766,46292,3111,9132,9799,68334
u,m,1974,10446,171694,52453,3341,10767,10236,76797
u,m,1975,9251,155574,46632,2891,8928,9107,67558
u,m,1976,9258,143042,42994,2758,8712,8605,63069
u,m,1977,8728,165720,47915,3085,8779,9509,69288
u,m,1978,10301,174627,56203,3534,10474,10830,81041
u,m,1979,10916,201096,57437,3660,10980,12920,84997
u,m,1980,10119,196531,55816,3431,10762,11838,81847
u,m,1981,10416,216077,57595,4006,10905,12118,84624
u,m,1982,10184,215791,62044,3871,11631,12721,90267
u,m,1983,9753,259078,64791,3812,11734,13236,93573
u,m,1984,11115,157481,76047,4095,13754,17014,110910
u,m,1985,9358,195367,55524,3230,9845,11614,80213
u,m,1986,9366,142803,47687,3010,8906,9467,69070
u,m,1987,9391,128843,48699,3054,9012,10109,70874
u,m,1988,10880,180844,56926,3518,10644,12674,83762
u,m,1989,11104,158394,52671,3411,10019,10612,76713
u,m,1990,11991,196062,60818,3667,11289,12515,88289
u,m,1991,11315,198753,62941,4340,13486,13846,94613
u,m,1992,9171,121028,41413,2942,8493,9253,62101
u,m,1993,9851,121576,44159,3186,9122,10275,66742
u,m,1994,10118,172668,51622,3447,10215,11625,76909
u,m,1995,10557,200273,60910,3824,11340,12922,88996
u,m,1996,10610,164399,51091,3259,9924,11947,76221
u,m,1997,13438,210296,65919,4485,13359,15555,99318
u,m,1998,10323,191918,53728,2984,9887,11842,78441
u,m,1999,10593,204110,57226,3660,10801,12817,84504
u,m,2000,12501,211327,68850,4651,13864,14705,102070
u,m,2001,10522,164479,54115,3351,10060,11865,79391
u,m,2002,10305,155892,54625,3555,9884,10965,79029
u,m,2003,10778,146451,54111,3713,11227,12005,81056
u,m,2004,11577,166687,57110,3898,11066,12987,85061
u,m,2005,11146,148998,55477,3982,11534,12690,83683
u,m,2006,10989,134846,53954,3395,10576,11819,79744
u,m,2007,10382,155911,50909,3268,9994,10928,75099
u,m,2008,9138,115276,48605,2935,8731,11411,71682
u,m,2009,7059,105344,42362,2613,7660,8453,61088
u,m,2010,83,257,360,29,41,47,477
u,m,2011,70,7555,1332,20,259,226,1837
u,m,2012,0,0,0,0,0,0,0
u,m,2013,16,0,181,23,63,41,308
u,m,2014,0,0,0,0,0,0,0
f,u,1922,1426,90731,51540,3690,11554,29684,96468
f,u,1923,4656,535406,158067,12718,35880,105332,311997
f,u,1924,4191,413320,143809,11820,30691,86491,272811
f,u,1925,4311,478131,161941,12226,35578,103743,313488
f,u,1926,5526,531935,184058,15243,40678,111862,351841
f,u,1927,4589,377371,148322,11927,32579,88391,281219
f,u,1928,5049,564565,205284,16069,43433,126954,391740
f,u,1929,6552,765470,237530,18195,52646,150536,458907
f,u,1930,6571,721583,246136,19076,51547,141199,457958
f,u,1931,5710,476834,192456,16166,41101,116474,366197
f,u,1932,4246,401539,158003,12322,31485,92207,294017
f,u,1933,5096,543394,186947,15597,38509,110997,352050
f,u,1934,4068,328053,135785,11431,27513,77252,251981
f,u,1935,4814,506472,189779,14868,36486,112976,354109
f,u,1936,5509,524636,182238,14231,33804,101942,332215
f,u,1937,4674,484052,193558,14748,36021,111752,356079
f,u,1938,3913,398778,156084,10933,28002,84726,279745
f,u,1939,3379,335457,114501,8248,22001,62110,206860
f,u,1940,3671,405926,144731,10465,26084,73622,254902
f,u,1941,4339,507280,164285,11938,28810,89825,294858
f,u,1942,3758,387716,140303,10404,26128,74318,251153
f,u,1943,4609,436460,157671,11678,28423,80217,277989
f,u,1944,3746,310838,118511,8720,21172,64207,212610
f,u,1945,5470,531941,184269,13622,32726,95866,326483
f,u,1946,7523,636785,249955,19675,46939,135834,452403
f,u,1947,7536,864133,298006,22596,53625,160075,534302
f,u,1948,7381,676749,263971,21359,52705,147281,485316
f,u,1949,5819,514651,201891,14537,36513,105317,358258
f,u,1950,8055,916222,320986,25070,66231,184045,596332
f,u,1951,6963,708826,283077,21603,54217,157405,516302
f,u,1952,6807,748703,256606,20422,51507,147321,475856
f,u,1953,7058,567923,208648,15063,38942,110764,373417
f,u,1954,5859,626419,222817,16005,40509,117394,396725
f,u,1955,6813,781333,263147,18949,49470,144008,475574
f,u,1956,7533,755236,278832,21312,54741,151171,506056
f,u,1957,8017,835590,319620,24589,61107,167414,572730
f,u,1958,5812,522449,204917,14920,39125,112731,371693
f,u,1959,6990,559735,202068,15569,40621,117640,375898
f,u,1960,8727,745445,311540,22929,60104,167970,562543
f,u,1961,9217,816153,323295,24360,60303,180333,588291
f,u,1962,9374,841330,312295,23478,59156,167637,562566
f,u,1963,8068,717790,267177,19716,51360,148647,486900
f,u,1964,8037,703707,280471,20773,53661,153964,508869
f,u,1965,9391,714586,293283,23266,58628,160563,535740
f,u,1966,9227,784205,312414,23261,59143,173504,568322
f,u,1967,11725,1020241,408390,30878,80514,234214,753996
f,u,1968,12150,965207,397690,29246,79147,224547,730630
f,u,1969,13571,1128132,412795,33039,81944,236085,763863
f,u,1970,12938,1087736,411155,31054,81826,235044,759079
f,u,1971,9521,621967,266880,20859,52801,152323,492863
f,u,1972,9472,796320,308152,23526,61272,177187,570137
f,u,1973,8548,498463,259335,20826,51491,143886,475538
f,u,1974,8405,555431,267335,21186,54462,155743,498726
f,u,1975,10677,824299,347137,27274,71332,200162,645905
f,u,1976,11632,935559,359754,27454,70057,200427,657692
f,u,1977,10925,875396,365712,27085,69654,197126,659577
f,u,1978,9259,738446,326572,23279,60376,178176,588403
f,u,1979,11147,910556,360792,27656,68972,202036,659456
f,u,1980,10504,744221,322160,24165,60220,176378,582923
f,u,1981,11155,826988,351563,26887,66749,190694,635893
f,u,1982,11352,878048,363626,27760,68801,192304,652491
f,u,1983,12902,909064,391050,29141,72968,208338,701497
f,u,1984,10719,729586,357152,26017,65057,198909,647135
f,u,1985,12236,931566,399168,29890,73394,220139,722591
f,u,1986,12209,871257,397792,28259,74155,218754,718960
f,u,1987,11054,731019,336702,25982,62457,182131,607272
f,u,1988,12984,908152,402206,30271,75153,225613,733243
f,u,1989,14327,848782,431432,30927,78869,238915,780143
f,u,1990,15724,1053314,489013,35669,88309,270503,883494
f,u,1991,14487,969499,458235,33881,87402,256623,836141
f,u,1992,15464,975792,497672,36275,90795,279581,904323
f,u,1993,15235,904721,464745,33542,84671,259336,842294
f,u,1994,15349,1023098,494799,36248,90568,277203,898818
f,u,1995,13155,926417,393856,27973,74359,226960,723148
f,u,1996,14189,922248,416693,31654,78724,237187,764258
f,u,1997,12823,808311,384060,27780,72198,216865,700903
f,u,1998,12433,814380,386369,27720,70124,218291,702504
f,u,1999,12985,778035,388545,27694,70812,224791,711842
f,u,2000,12701,857516,371359,26176,70018,213419,680972
f,u,2001,10404,757636,338999,22792,59594,197620,619005
f,u,2002,10425,752189,324648,22821,60145,188534,596148
f,u,2003,9444,613803,293550,20970,55318,168902,538740
f,u,2004,11108,630537,328824,24011,60659,189382,602876
f,u,2005,11978,751477,393091,28027,71406,219776,712300
f,u,2006,12044,761794,412715,27554,69654,231698,741621
f,u,2007,13113,840140,438380,28992,74972,238571,780915
f,u,2008,7700,471965,264597,19419,49817,145453,479286
f,u,2009,3257,169268,115225,8165,21503,64238,209131
f,u,2010,659,40616,15917,1208,2909,8577,28611
f,u,2011,4,0,0,0,0,1,1
f,u,2012,0,0,0,0,0,0,0
f,u,2013,0,0,0,0,0,0,0
f,u,2014,0,0,0,0,0,0,0
f,f,1922,3,0,14,6,1,5,26
f,f,1923,1279,151234,60301,4904,11958,34597,111760
f,f,1924,1701,259408,85286,6643,16477,53230,161636
f,f,1925,1777,233137,93102,7146,18664,54883,173795
f,f,1926,2063,292776,99924,7730,19891,62191,189736
f,f,1927,2219,301033,113950,8972,22067,67711,212700
f,f,1928,2405,334950,119602,8906,21609,67794,217911
f,f,1929,2537,330465,130491,10274,24519,76651,241935
f,f,1930,2317,308214,135266,10178,25806,77987,249237
f,f,1931,2452,336864,126235,10027,24358,72599,233219
f,f,1932,1980,284074,124251,9132,22247,69383,225013
f,f,1933,2111,249463,109699,8035,19077,62769,199580
f,f,1934,2736,375463,144023,11173,25847,80823,261866
f,f,1935,2973,383653,152205,11547,28475,86024,278251
f,f,1936,3406,459633,169134,13234,31643,95429,309440
f,f,1937,2870,429044,167269,11914,27597,86992,293772
f,f,1938,2914,470072,186309,12850,31754,109832,340745
f,f,1939,1827,240938,89785,6409,15825,47005,159024
f,f,1940,1626,272247,100540,6831,16605,48094,172070
f,f,1941,2733,402425,130068,9414,23278,71620,234380
f,f,1942,2145,380297,126501,9297,22184,67471,225453
f,f,1943,2302,313418,117344,8175,19372,56335,201226
f,f,1944,2363,336171,118143,8617,20238,61910,208908
f,f,1945,2746,411265,143066,9884,24213,76711,253874
f,f,1946,3369,467320,160713,11701,27104,84539,284057
f,f,1947,3048,408117,153750,11443,25567,77156,267916
f,f,1948,2540,406283,145368,10721,25045,75599,256733
f,f,1949,2703,425925,154628,10740,25290,77712,268370
f,f,1950,2781,381185,156290,10862,25953,77748,270853
f,f,1951,3109,514057,172140,11726,28415,85076,297357
f,f,1952,2996,377430,144279,10766,26043,75986,257074
f,f,1953,2783,375825,144246,9764,23877,71778,249665
f,f,1954,3037,401181,160827,11113,28078,84738,284756
f,f,1955,2834,411108,154352,10103,25076,74787,264318
f,f,1956,2598,373248,141790,10724,24354,71238,248106
f,f,1957,2714,336333,135025,10146,24440,67736,237347
f,f,1958,2307,287880,106291,7499,17917,54414,186121
f,f,1959,2233,283175,114138,7578,18796,56812,197324
f,f,1960,2550,287135,124688,8815,20804,62074,216381
f,f,1961,2262,274321,112109,7728,18551,55859,194247
f,f,1962,2249,266555,106282,7754,18026,53465,185527
f,f,1963,2195,241243,114164,7774,19173,57133,198244
f,f,1964,2405,245189,110167,8437,18879,52854,190337
f,f,1965,2190,229267,102541,7623,18483,51568,180215
f,f,1966,2472,242602,106957,7801,18082,50435,183275
f,f,1967,2327,203110,95108,7122,16895,49444,168569
f,f,1968,2644,292068,133370,9257,23199,68857,234683
f,f,1969,2588,293190,131637,9472,22381,63987,227477
f,f,1970,3003,276114,117648,9165,20993,57041,204847
f,f,1971,1881,154983,79165,5902,13670,42355,141092
f,f,1972,1759,170907,73921,5222,12927,38482,130552
f,f,1973,2629,230623,130116,9522,23322,65538,228498
f,f,1974,2172,220013,96105,7101,17150,51922,172278
f,f,1975,2872,281402,124644,9175,22037,65630,221486
f,f,1976,2990,304659,132368,10292,23861,69625,236146
f,f,1977,2401,236271,110536,7890,19668,57785,195879
f,f,1978,2724,290749,147370,10431,23870,77476,259147
f,f,1979,3573,387943,185838,13892,32740,100143,332613
f,f,1980,3531,381484,197759,13220,32807,105314,349100
f,f,1981,3528,441728,207193,13766,34195,108499,363653
f,f,1982,3454,454148,212180,13641,33154,107720,366695
f,f,1983,2605,253265,155574,10724,25695,76515,268508
f,f,1984,3213,340595,167599,11182,26905,84050,289736
f,f,1985,3809,406453,209659,13980,34121,111644,369404
f,f,1986,3330,320279,173833,11939,29072,92860,307704
f,f,1987,4415,507808,253834,17519,41684,136835,449872
f,f,1988,5000,514272,254847,15951,40045,133803,444646
f,f,1989,5189,425067,266655,17758,43229,136635,464277
f,f,1990,5092,410883,229810,15810,37977,122899,406496
f,f,1991,5569,550991,290023,20079,48353,150320,508775
f,f,1992,5555,612240,309537,19540,48636,159728,537441
f,f,1993,5455,504717,266270,17686,43972,143831,471759
f,f,1994,6518,702573,379339,23269,59055,200586,662249
f,f,1995,5880,641707,316320,20226,51364,165999,553909
f,f,1996,7102,792329,367515,23397,59068,193458,643438
f,f,1997,6957,705555,330780,21194,55389,186459,593822
f,f,1998,6134,610120,322774,21475,52788,179769,576806
f,f,1999,6580,760009,367372,24132,59795,197980,649279
f,f,2000,6128,719397,370223,24606,59394,197452,651675
f,f,2001,6295,672050,331715,21520,53546,176367,583148
f,f,2002,6309,586105,306905,20665,49861,164993,542424
f,f,2003,6348,665602,356123,23769,58565,197010,635467
f,f,2004,6161,631048,317615,21782,52819,170214,562430
f,f,2005,6457,697830,345389,22884,57594,190516,616383
f,f,2006,6444,730336,389139,24631,60855,214403,689028
f,f,2007,6584,641696,369014,24336,60318,205692,659360
f,f,2008,5956,447039,337269,21727,55855,179166,594017
f,f,2009,3501,193531,186214,12604,30875,103586,333279
f,f,2010,3,0,124,2,17,66,209
f,f,2011,0,0,0,0,0,0,0
f,f,2012,0,0,0,0,0,0,0
f,f,2013,0,0,0,0,0,0,0
f,f,2014,0,0,0,0,0,0,0
f,m,1922,392,41598,14317,932,2594,9324,27167
f,m,1923,4249,513751,174916,13969,36182,104461,329528
f,m,1924,4421,541945,188991,14139,36853,106964,346947
f,m,1925,3632,460450,158224,12340,32054,95932,298550
f,m,1926,3864,487777,156497,12536,31424,91329,291786
f,m,1927,4769,569126,187366,14090,39464,112487,353407
f,m,1928,4271,455278,155582,12524,32905,87994,289005
f,m,1929,4939,510308,184683,14191,38115,106077,343066
f,m,1930,4973,556998,180870,14603,37579,103045,336097
f,m,1931,3475,349055,127516,9564,25386,70485,232951
f,m,1932,4104,413157,165137,13243,32688,89838,300906
f,m,1933,4205,418978,151226,12466,30332,84385,278409
f,m,1934,4257,449273,169057,14161,34310,95219,312747
f,m,1935,5169,515833,195558,14956,37422,108955,356891
f,m,1936,3580,403182,148998,11469,27763,81764,269994
f,m,1937,4842,495002,193855,14708,35383,97819,341765
f,m,1938,3418,338395,129159,9847,24250,64802,228058
f,m,1939,2865,289044,104159,7905,19573,55510,187147
f,m,1940,3525,357328,142072,10187,26679,71271,250209
f,m,1941,3302,317245,125342,9285,23587,67388,225602
f,m,1942,3331,305751,120475,8920,23104,62433,214932
f,m,1943,3678,391696,134887,9738,24373,65206,234204
f,m,1944,2874,278943,104265,7512,19149,52658,183584
f,m,1945,3764,359433,136081,10289,24544,66906,237820
f,m,1946,5253,531671,195517,14190,34786,98160,342653
f,m,1947,5999,586910,214278,16133,38687,108485,377583
f,m,1948,4673,481273,181922,13463,33159,94523,323067
f,m,1949,4713,460461,169159,12734,31091,85468,298452
f,m,1950,5459,607448,210613,14372,37086,104858,366929
f,m,1951,5829,571258,221554,16004,41313,111951,390822
f,m,1952,5623,623833,225995,16488,41481,113952,397916
f,m,1953,5084,540889,200302,13975,35773,97637,347687
f,m,1954,5646,581400,217878,15909,39066,109653,382506
f,m,1955,5804,652244,217390,15719,38973,108284,380366
f,m,1956,5163,554080,203687,13855,36054,103835,357431
f,m,1957,4836,473509,178167,12128,32605,87724,310624
f,m,1958,4930,463209,184324,13346,34786,90726,323182
f,m,1959,5531,539028,195264,13437,34253,98348,341302
f,m,1960,5431,461268,186822,14224,34564,94388,329998
f,m,1961,6324,541580,224752,16359,41953,112351,395415
f,m,1962,5585,498018,185006,13293,33765,90345,322409
f,m,1963,5728,380974,185020,13415,35078,96624,330137
f,m,1964,5555,466935,203738,14881,37175,101625,357419
f,m,1965,5947,464899,185811,12750,33494,94374,326429
f,m,1966,6439,524866,214002,15278,38858,112082,380220
f,m,1967,6340,498794,226783,16150,41875,116791,401599
f,m,1968,7312,594685,252274,18833,47229,131021,449357
f,m,1969,7740,554804,242156,17434,43902,125418,428910
f,m,1970,7261,520832,227199,16433,41885,116644,402161
f,m,1971,5642,375998,171155,12540,31833,89836,305364
f,m,1972,4852,331968,154184,11000,29157,79816,274157
f,m,1973,5817,378683,173070,12584,31961,88526,306141
f,m,1974,5524,343435,160926,11557,29861,83082,285426
f,m,1975,4989,390647,171453,11424,31145,88210,302232
f,m,1976,4990,396433,186038,12322,32758,94315,325433
f,m,1977,5011,340880,159002,11081,28110,81233,279426
f,m,1978,6291,521955,228587,15432,40279,110802,395100
f,m,1979,5620,474794,195958,13706,34616,103999,348279
f,m,1980,5812,495613,203065,13851,35293,99490,351699
f,m,1981,5785,480711,222295,15539,38646,113011,389491
f,m,1982,5677,478746,209740,13648,36556,103354,363298
f,m,1983,5011,387810,182388,12069,31857,94236,320550
f,m,1984,5851,460634,210068,14254,37099,104810,366231
f,m,1985,5045,464729,189581,12471,32839,94862,329753
f,m,1986,5471,415256,203494,12972,33994,103896,354356
f,m,1987,5924,421409,199031,13603,34710,101860,349204
f,m,1988,6331,487014,230088,14655,39648,123102,407493
f,m,1989,6686,507207,245257,16586,43016,126727,431586
f,m,1990,6694,535826,233418,15124,40689,122750,411981
f,m,1991,6757,494591,250243,16897,43289,134118,444547
f,m,1992,5862,443596,211505,13988,36054,106823,368370
f,m,1993,6262,438584,218943,14604,38512,112266,384325
f,m,1994,6152,445086,207768,13584,35842,108682,365876
f,m,1995,6472,610516,261131,16520,44401,138844,460896
f,m,1996,6188,499982,225903,14546,37753,122132,400334
f,m,1997,7582,656184,283574,18307,49281,146821,497983
f,m,1998,6688,477918,236864,15651,41666,132210,426391
f,m,1999,6054,479994,247732,16245,41904,131421,437302
f,m,2000,7512,603195,277033,18033,47792,145205,488063
f,m,2001,6796,507387,236689,15727,40822,125605,418843
f,m,2002,6352,503865,238507,15141,40421,128207,422276
f,m,2003,7098,588782,272212,17851,46566,141917,478546
f,m,2004,7802,510349,280593,18766,48276,148087,495722
f,m,2005,6972,508835,254761,16596,44513,135008,450878
f,m,2006,6625,404638,237481,15908,40417,127030,420836
f,m,2007,6719,471889,262203,17793,45450,137933,463379
f,m,2008,5437,334286,216209,14333,38019,115047,383608
f,m,2009,4436,228618,165435,10869,28502,83808,288614
f,m,2010,73,4265,3635,264,561,1795,6255
f,m,2011,32,4590,1139,25,172,509,1845
f,m,2012,0,0,0,0,0,0,0
f,m,2013,3,0,18,3,2,9,32
f,m,2014,0,0,0,0,0,0,0
m,u,1922,3772,120243,91354,6544,21461,46051,165410
m,u,1923,14061,1068767,335818,24717,75909,188310,624754
m,u,1924,11229,725566,251936,19840,53558,135297,460631
m,u,1925,12711,981460,316451,24425,71608,176331,588815
m,u,1926,16010,1009848,339970,26513,77547,190328,634358
m,u,1927,14111,821262,287666,22940,64251,157295,532152
m,u,1928,14788,1040769,401830,29567,85648,222784,739829
m,u,1929,19630,1407090,473453,36556,104528,261379,875916
m,u,1930,17702,1464219,496602,36326,109231,264355,906514
m,u,1931,15479,1152815,403534,30502,83756,212333,730125
m,u,1932,12931,906505,313248,23134,63967,165004,565353
m,u,1933,13530,1122038,373609,27892,76682,187118,665301
m,u,1934,11757,745946,286499,21872,57454,147324,513149
m,u,1935,13540,1142456,381437,29031,73119,194501,678088
m,u,1936,16359,1097444,366888,28552,71521,195052,662013
m,u,1937,14105,1108002,374525,27142,72605,184359,658631
m,u,1938,12505,855606,335564,24707,64558,168231,593060
m,u,1939,11110,951161,303664,20622,56934,148534,529754
m,u,1940,11135,934314,324249,22469,59600,151684,558002
m,u,1941,11474,914416,318409,22178,63485,160130,564202
m,u,1942,13228,1035485,348909,24625,63493,160616,597643
m,u,1943,14738,1007680,379078,26857,68126,173137,647198
m,u,1944,11946,772371,272683,19497,50062,131188,473430
m,u,1945,15942,1217534,420964,30687,74731,195806,722188
m,u,1946,23870,1766578,618137,45559,114795,299500,1077991
m,u,1947,21446,1849274,648577,47412,118733,309939,1124661
m,u,1948,21642,1521487,582371,43141,114763,282488,1022763
m,u,1949,17516,1200011,466496,33045,90722,225871,816134
m,u,1950,21911,2098398,703362,49887,143538,357795,1254582
m,u,1951,19622,1657428,634753,47037,123612,310245,1115647
m,u,1952,19088,1658966,570145,42854,114693,285775,1013467
m,u,1953,21230,1416810,501033,35813,96277,246313,879436
m,u,1954,17970,1437876,541266,37596,101064,264097,944023
m,u,1955,22182,1771227,628239,43991,115642,307373,1095245
m,u,1956,21510,1748386,631720,44874,119912,301251,1097757
m,u,1957,22427,1813743,637376,47590,121199,299431,1105596
m,u,1958,18158,1335097,527138,36299,98337,257371,919145
m,u,1959,21066,1387921,490150,35554,99255,249114,874073
m,u,1960,23764,1881958,714165,47968,135846,355183,1253162
m,u,1961,26590,2046244,757439,53351,146563,388211,1345564
m,u,1962,28171,2160583,761637,53359,150020,377341,1342357
m,u,1963,24584,1610460,650753,46854,127243,325477,1150327
m,u,1964,24658,1737669,657968,46613,126984,326605,1158170
m,u,1965,28887,1820545,741936,53678,142235,358599,1296448
m,u,1966,26769,1959751,676915,48364,127489,332292,1185060
m,u,1967,36120,2316649,890597,65313,180026,446766,1582702
m,u,1968,41082,2259417,903660,66147,186729,446461,1602997
m,u,1969,38012,2425993,869958,65648,173459,447871,1556936
m,u,1970,39137,2199572,847598,65090,175978,441640,1530306
m,u,1971,25960,1429756,583156,43085,113673,297074,1036988
m,u,1972,27403,1753421,656397,47616,126069,318260,1148342
m,u,1973,25512,1242002,577189,43361,115015,285756,1021321
m,u,1974,23786,1258491,560005,41020,109233,266003,976261
m,u,1975,29234,1667984,663693,50160,132773,328834,1175460
m,u,1976,33946,2043804,786523,57963,154822,384668,1383976
m,u,1977,30525,1748850,731553,52376,140386,353566,1277881
m,u,1978,28492,1830133,707241,49015,132861,351024,1240141
m,u,1979,31201,1908928,734964,52838,140724,348747,1277273
m,u,1980,29520,1578756,707803,49843,129143,340939,1227728
m,u,1981,31975,1854320,713354,51297,137540,342983,1245174
m,u,1982,31104,1807830,720259,52801,138291,348856,1260207
m,u,1983,37003,1978028,780076,55874,151564,379731,1367245
m,u,1984,29528,1443303,658392,47775,123463,317448,1147078
m,u,1985,32607,1617823,724014,52695,135110,349251,1261070
m,u,1986,32571,1787621,733192,53527,141072,354436,1282227
m,u,1987,29189,1419121,656836,47985,123269,313451,1141541
m,u,1988,32960,1776483,754827,55651,141493,367068,1319039
m,u,1989,35308,1727736,805841,57883,152406,391902,1408032
m,u,1990,39439,2060951,880864,63970,165888,444171,1554893
m,u,1991,38483,1732117,835834,60981,159361,412501,1468677
m,u,1992,40127,2025211,936444,67811,178594,464426,1647275
m,u,1993,37867,1658467,863502,63714,163391,423904,1514511
m,u,1994,37034,1913545,863123,63581,164873,417931,1509508
m,u,1995,32357,1579556,682962,49012,132994,341471,1206439
m,u,1996,35186,1778526,742602,55413,148114,365114,1311243
m,u,1997,32841,1609257,740989,53114,143687,362251,1300041
m,u,1998,31218,1410685,688747,50440,133453,346906,1219546
m,u,1999,30095,1494331,703462,48627,130834,347415,1230338
m,u,2000,32152,1453531,677412,49054,132098,337076,1195640
m,u,2001,26592,1392833,603275,42154,111600,302125,1059154
m,u,2002,28904,1462641,622129,44481,116038,303668,1086316
m,u,2003,25943,1407342,593805,41644,112526,292982,1040957
m,u,2004,29223,1342640,643919,46732,123311,316581,1130543
m,u,2005,31180,1513615,725892,51390,139004,354628,1270914
m,u,2006,29729,1482410,738784,49845,131706,359042,1279377
m,u,2007,33229,1788212,849907,57287,153770,408294,1469258
m,u,2008,18845,887209,468960,33750,89994,225992,818696
m,u,2009,8845,302636,196454,14663,37381,96345,344843
m,u,2010,1548,66646,31898,2446,6576,15802,56722
m,u,2011,31,1795,34,8,23,0,65
m,u,2012,0,0,0,0,0,0,0
m,u,2013,0,0,0,0,0,0,0
m,u,2014,0,0,0,0,0,0,0
m,f,1922,9,0,50,2,6,4,62
m,f,1923,2422,242407,76104,5802,15386,37682,134974
m,f,1924,3078,242284,89480,7071,18488,47166,162205
m,f,1925,2885,208375,89889,7264,18896,44811,160860
m,f,1926,3442,283991,96177,7538,19428,48549,171692
m,f,1927,3573,330778,118558,10001,25045,60654,214258
m,f,1928,4111,346390,129080,10322,26143,63662,229207
m,f,1929,4542,385467,140758,11529,28729,74825,255841
m,f,1930,3975,354801,130300,10019,27081,62212,229612
m,f,1931,4592,458090,167269,13297,33511,80838,294915
m,f,1932,3761,329828,127729,9918,25515,64446,227608
m,f,1933,4098,345184,130314,10187,25809,64924,231234
m,f,1934,5118,415749,161082,12816,32356,79450,285704
m,f,1935,5787,469369,170036,13343,33657,85402,302438
m,f,1936,5972,482727,177558,14219,36167,85840,313784
m,f,1937,5192,491514,167317,12605,31625,78627,290174
m,f,1938,5841,458953,172844,13794,34624,85696,306958
m,f,1939,3862,371529,130771,9300,24356,62402,226829
m,f,1940,3398,316526,112694,7740,20855,49872,191161
m,f,1941,4913,502444,168521,11979,32018,79325,291843
m,f,1942,4514,416669,142202,11145,27142,66426,246915
m,f,1943,4519,389171,143272,10604,26262,64337,244475
m,f,1944,4982,465982,154059,11396,28471,73135,267061
m,f,1945,5257,563180,177344,12363,31038,78631,299376
m,f,1946,6726,671413,212745,14723,37217,94401,359086
m,f,1947,5836,517508,187665,13969,33235,85082,319951
m,f,1948,4794,507457,172515,12779,31845,76785,293924
m,f,1949,5121,496032,167314,12308,29672,76539,285833
m,f,1950,5623,473703,188053,14008,34338,83826,320225
m,f,1951,5710,477341,179094,13283,32675,82296,307348
m,f,1952,6001,511654,199946,14960,37096,93727,345729
m,f,1953,5456,503532,191703,13870,34844,83469,323886
m,f,1954,6246,516381,201236,14380,38120,96125,349861
m,f,1955,5569,505685,179866,12535,32988,81110,306499
m,f,1956,4942,468734,173937,12940,31471,75637,293985
m,f,1957,4974,417102,169322,12780,30834,70606,283542
m,f,1958,4899,421016,147603,11214,26925,64590,250332
m,f,1959,4306,375797,139699,9966,24882,61614,236161
m,f,1960,5605,536706,193041,13714,34511,81560,322826
m,f,1961,4655,368504,153298,11367,27367,70333,262365
m,f,1962,4764,392452,160743,11321,28962,72219,273245
m,f,1963,4401,370268,157855,11100,28532,69435,266922
m,f,1964,4564,326909,145671,10724,26243,62639,245277
m,f,1965,4326,386684,165652,11792,30865,74014,282323
m,f,1966,4728,400888,158030,11197,27760,67707,264694
m,f,1967,4408,289208,129555,9828,24403,57769,221555
m,f,1968,5168,416691,176694,12769,32800,79057,301320
m,f,1969,5012,401046,161807,11457,29141,72868,275273
m,f,1970,6921,452741,183892,13829,34030,79231,310982
m,f,1971,3772,229255,109115,8048,18960,50629,186752
m,f,1972,3586,222044,106779,7844,19556,47847,182026
m,f,1973,5180,325906,152839,11669,28704,70862,264074
m,f,1974,4491,263616,131122,10107,25442,62969,229640
m,f,1975,5450,325105,143447,10972,27912,64298,246629
m,f,1976,5646,417584,171096,12895,31082,73164,288237
m,f,1977,4650,293546,134374,10140,25180,61457,231151
m,f,1978,5291,399222,175477,12935,32019,84819,305250
m,f,1979,7016,473893,202542,14545,37191,93398,347676
m,f,1980,6510,416207,198747,14290,36562,94641,344240
m,f,1981,6460,463151,205026,14980,38174,92059,350239
m,f,1982,6686,439110,195839,14673,36450,89057,336019
m,f,1983,5048,258243,163748,11895,29773,72840,278256
m,f,1984,6160,425722,180661,12933,33470,84693,311757
m,f,1985,7333,478359,212464,14873,37654,97614,362605
m,f,1986,6217,403470,183430,13237,33565,82050,312282
m,f,1987,7697,525492,237202,16878,43038,110592,407710
m,f,1988,9566,770918,310104,21408,55724,145952,533188
m,f,1989,9070,501789,274220,18781,49907,120627,463535
m,f,1990,9221,540424,257789,18446,47910,119092,443237
m,f,1991,10024,537118,283542,20496,51072,127572,482682
m,f,1992,10380,663113,318860,22399,56959,145227,543445
m,f,1993,9509,584628,276760,19071,50973,131376,478180
m,f,1994,11927,820598,385409,25288,68226,178701,657624
m,f,1995,10818,708733,338172,23414,61036,154470,577092
m,f,1996,12840,939974,389796,26182,68933,171232,656143
m,f,1997,13169,889892,397235,27800,72783,192666,690484
m,f,1998,10815,729392,330456,23619,61693,159601,575369
m,f,1999,11701,770545,375967,26523,66715,167444,636649
m,f,2000,11215,721800,375461,27469,68486,171978,643394
m,f,2001,11582,791728,363820,25454,66449,171735,627458
m,f,2002,11560,793263,360722,25565,63817,164036,614140
m,f,2003,12008,786602,387470,28338,71044,178489,665341
m,f,2004,11320,822186,375053,26223,67125,167960,636361
m,f,2005,12007,802179,389503,27328,70220,183513,670564
m,f,2006,11560,812415,420458,29383,75152,195684,720677
m,f,2007,12366,754506,413520,28625,74446,193688,710279
m,f,2008,11614,578738,392420,27733,73406,185591,679150
m,f,2009,6280,235689,213100,14912,39841,100105,367958
m,f,2010,6,0,60,2,8,54,124
m,f,2011,0,0,0,0,0,0,0
m,f,2012,0,0,0,0,0,0,0
m,f,2013,0,0,0,0,0,0,0
m,f,2014,0,0,0,0,0,0,0
m,m,1922,983,84569,26850,1723,4919,15342,48834
m,m,1923,12466,1235028,398927,29190,79866,214727,722710
m,m,1924,12366,1182511,394996,28801,78173,201719,703689
m,m,1925,11495,1195884,364078,27265,72544,196093,659980
m,m,1926,11391,1027887,332030,24864,68042,177990,602926
m,m,1927,14318,1419058,450549,33416,93432,236693,814090
m,m,1928,13667,1222209,403470,29299,81626,207802,722197
m,m,1929,14544,1216226,441508,32365,89841,220667,784381
m,m,1930,15236,1508416,481400,35728,95328,244168,856624
m,m,1931,10608,981330,339656,23264,64917,163521,591358
m,m,1932,12197,1147627,411265,30343,80004,194592,716204
m,m,1933,12804,1189983,402208,28852,76097,195236,702393
m,m,1934,12459,1266641,445543,32709,85655,218681,782588
m,m,1935,16231,1426907,511082,37641,95817,249492,894032
m,m,1936,12128,1064746,382389,27721,72233,188334,670677
m,m,1937,14705,1222791,455515,32922,83143,213599,785179
m,m,1938,11161,1049301,367699,25472,66546,170974,630691
m,m,1939,9523,834352,297858,20449,54296,140853,513456
m,m,1940,11993,1229146,425282,28285,74401,190326,718294
m,m,1941,10336,983938,335831,22646,59820,155034,573331
m,m,1942,12404,1065924,406418,27653,74144,186832,695047
m,m,1943,13048,1185765,410275,28040,68223,174167,680705
m,m,1944,10422,858633,309400,21669,53353,139030,523452
m,m,1945,12444,1016408,368798,25149,60636,159058,613641
m,m,1946,16762,1375488,506055,34804,87139,226180,854178
m,m,1947,19947,1616100,581874,40959,100405,271731,994969
m,m,1948,14762,1335432,494468,33518,84351,221250,833587
m,m,1949,15383,1385362,480929,32593,83551,213642,810715
m,m,1950,16373,1818370,609131,39135,102085,276356,1026707
m,m,1951,16836,1655303,604205,40640,104625,265782,1015252
m,m,1952,16861,1520939,574922,40009,101142,255676,971749
m,m,1953,16085,1570789,552920,36665,96136,248562,934283
m,m,1954,18101,1603849,597277,39604,99953,258036,994870
m,m,1955,18585,1713759,653305,43379,110931,284956,1092571
m,m,1956,17609,1528932,569492,37104,94892,250485,951973
m,m,1957,15284,1417713,526415,33311,87660,224741,872127
m,m,1958,15448,1479612,562713,37014,96761,238267,934755
m,m,1959,17287,1591526,572416,36766,96214,256360,961756
m,m,1960,16658,1343996,519829,35721,90841,225946,872337
m,m,1961,19404,1687861,631297,42013,106724,273600,1053634
m,m,1962,17128,1388490,548682,36205,93169,228756,906812
m,m,1963,17991,1209777,523689,35712,90604,231190,881195
m,m,1964,18562,1529187,613079,40210,102499,270272,1026060
m,m,1965,20195,1523733,601475,39142,103513,278140,1022270
m,m,1966,20012,1471611,640278,41843,107346,279097,1068564
m,m,1967,20820,1643322,696085,45700,120635,307595,1170015
m,m,1968,23618,1766882,736801,49789,126852,320823,1234265
m,m,1969,24600,1695716,712310,47595,121615,311867,1193387
m,m,1970,23085,1570145,680310,44437,114845,300974,1140566
m,m,1971,19520,1361679,565683,36786,95442,255921,953832
m,m,1972,16075,1026578,461108,30049,79888,206620,777665
m,m,1973,18921,1281383,573504,37278,95212,265583,971577
m,m,1974,18822,1167223,541813,35343,93788,250377,921321
m,m,1975,16263,1282263,544851,34117,93049,247953,919970
m,m,1976,17544,1281634,545915,34275,92431,250991,923612
m,m,1977,17184,1180682,524381,33209,86391,239480,883461
m,m,1978,20638,1574592,670160,42558,110751,292836,1116305
m,m,1979,19832,1577668,614113,38659,104524,278860,1036156
m,m,1980,19416,1527800,599357,37182,101102,264581,1002222
m,m,1981,18870,1382331,603131,38438,99935,265665,1007169
m,m,1982,19214,1604162,627108,39631,105117,277151,1049007
m,m,1983,16871,1331353,562247,35135,94780,251285,943447
m,m,1984,18776,1340073,593140,38425,101365,269266,1002196
m,m,1985,16805,1214646,537675,34576,91496,237130,900877
m,m,1986,17499,1086764,518142,32927,87156,232121,870346
m,m,1987,18408,1331420,602449,38063,100599,263160,1004271
m,m,1988,20651,1379938,602648,37897,102097,279468,1022110
m,m,1989,21387,1402392,644680,40566,108778,288678,1082702
m,m,1990,21205,1394577,619373,40096,106694,284690,1050853
m,m,1991,21305,1310423,620214,41183,106873,285459,1053729
m,m,1992,18080,1109294,525281,34941,89989,240227,890438
m,m,1993,19426,1231600,586012,37977,100457,264550,988996
m,m,1994,19377,1328453,587882,37844,99321,264204,989251
m,m,1995,20789,1674494,659003,40967,111166,303213,1114349
m,m,1996,20472,1461537,622904,38346,105103,285459,1051812
m,m,1997,23590,1773508,752717,47437,131189,350499,1281842
m,m,1998,20513,1389340,623174,39109,104668,296267,1063218
m,m,1999,19712,1395596,612379,37436,104872,280867,1035554
m,m,2000,24430,1554190,733882,47502,124952,337607,1243943
m,m,2001,20925,1188310,580549,37396,99622,269779,987346
m,m,2002,19724,1256074,592079,36716,98348,269872,997015
m,m,2003,21415,1494073,652026,41641,109562,294424,1097653
m,m,2004,23201,1441365,694639,43978,117037,317339,1172993
m,m,2005,20696,1284427,635089,41144,109509,293866,1079608
m,m,2006,21417,1211161,611774,39106,104473,285940,1041293
m,m,2007,20398,1223483,636475,41246,105852,287985,1071558
m,m,2008,17428,965785,569631,36162,96795,263059,965647
m,m,2009,12600,688900,430156,26479,71544,189247,717426
m,m,2010,211,4497,3878,277,641,1745,6541
m,m,2011,85,6866,2098,62,266,1015,3441
m,m,2012,0,0,0,0,0,0,0
m,m,2013,21,2072,1008,132,354,448,1942
m,m,2014,0,0,0,0,0,0,0
