chargender,authgender,date,characters,speaking,agent,mod,patient,poss,total
u,f,1948,2497,53213,15300,1103,3204,2948,22555
u,u,1926,10600,192268,40634,3152,10628,8817,63231
u,f,1909,2664,79992,11064,922,2633,2397,17016
f,u,1933,5195,577295,195653,16122,39977,115813,367565
u,u,1863,182,3572,582,72,150,126,930
f,u,2004,11108,630537,328824,24011,60659,189382,602876
u,u,1955,15497,368869,81532,5666,17748,16619,121565
u,u,1960,16870,385607,96344,5996,19928,19380,141648
u,m,1861,851,25254,2520,224,701,466,3911
m,m,1864,3722,572132,85960,7381,25017,54855,173213
m,u,1913,2172,233809,44316,3686,10339,22836,81177
f,f,2011,0,0,0,0,0,0,0
m,u,1966,26769,1959751,676915,48364,127489,332292,1185060
m,u,1919,2359,249710,61030,4893,12358,30660,108941
f,u,1835,123,22331,2497,198,782,1965,5442
u,u,1946,14732,329713,67719,4921,15049,13406,101095
m,u,1877,419,46866,8454,737,1927,5358,16476
f,u,1804,14,1744,890,43,270,927,2130
m,u,1993,37867,1658467,863502,63714,163391,423904,1514511
u,u,1837,116,7633,572,55,194,75,896
m,m,1911,15415,2380954,432707,31105,100537,224168,788517
u,f,1852,562,29124,3178,241,675,896,4990
m,m,1843,1874,295467,38015,2761,11080,27867,79723
m,f,1911,6371,831885,170745,13079,37318,85874,307016
u,m,1855,1253,37160,3947,280,1189,828,6244
m,f,1981,8281,722067,273644,19498,50376,124440,467958
m,u,1929,20114,1455390,489289,37805,107821,269445,904360
m,m,1931,12502,1354706,414357,27577,78613,198999,719546
u,m,1946,8978,191366,45364,2997,8903,9375,66639
f,f,1871,1422,360684,58635,5341,14145,43035,121156
m,m,1898,15406,2115983,367677,27599,91098,213147,699521
f,u,1817,75,9578,2241,186,1049,1892,5368
u,f,1934,2705,35282,10511,974,2663,2476,16624
m,u,1921,2239,322878,74431,5529,15803,35758,131521
f,u,1865,424,65950,12013,1042,2850,8367,24272
m,m,2009,12600,688900,430156,26479,71544,189247,717426
f,f,1838,635,139883,17754,1568,5643,17982,42947
m,f,1963,5043,478389,182490,12876,32915,78806,307087
u,f,1846,409,12512,1335,127,471,309,2242
m,u,1810,199,5901,1138,109,408,1033,2688
u,u,1943,9353,160195,41259,2754,9036,7857,60906
m,m,1841,2368,364594,47036,3549,15767,34241,100593
m,m,1907,12293,1608849,324143,23647,74073,171939,593802
f,f,1922,5216,1039119,233535,18670,47696,138512,438413
f,f,1949,3202,556844,184884,13142,30932,92650,321608
m,f,1834,1113,217651,26511,2267,7935,17387,54100
u,u,1961,19218,368060,103669,7520,21947,21848,154984
u,m,1856,1501,55702,4579,413,1469,963,7424
f,m,1980,6975,689176,259222,17636,45654,126821,449333
f,m,1963,6122,435991,198954,14446,37637,102969,354006
m,f,2013,0,0,0,0,0,0,0
u,f,1949,2656,54676,14500,1090,3011,2861,21462
m,f,1837,720,88903,13890,1162,4192,11298,30542
u,u,1883,422,12963,1290,119,409,340,2158
f,f,2002,6309,586105,306905,20665,49861,164993,542424
f,m,1941,3798,404906,144352,10511,26970,76238,258071
m,u,1988,33124,1802269,760733,56032,142480,370564,1329809
u,f,1907,2871,77007,11210,895,3025,2578,17708
f,m,1861,529,95783,14641,1386,4190,11010,31227
m,f,1841,1761,216692,36488,3104,11038,26975,77605
u,u,1806,55,299,189,24,109,48,370
u,m,1969,13642,232323,61737,4265,12399,11632,90033
m,f,1880,3853,433061,94822,8471,23976,57526,184795
u,f,1860,948,22900,3947,399,1226,1026,6598
u,m,2008,9138,115276,48605,2935,8731,11411,71682
f,u,1857,448,79470,14108,1153,3803,11740,30804
f,m,2013,3,0,18,3,2,9,32
m,f,1904,4504,477796,97928,7163,22137,55426,182654
f,f,1928,2411,346368,121210,8754,22273,70804,223041
f,u,1980,10526,748685,323460,24234,60469,177113,585276
m,u,1958,18225,1335167,529375,36404,98686,258216,922681
m,m,1900,10076,1147447,218869,16470,51786,122763,409888
f,m,1803,124,4626,1517,172,625,1850,4164
u,m,1982,12290,315956,80693,4913,14620,16220,116446
u,u,1927,9911,150499,37009,3005,10064,7325,57403
f,m,1841,673,130045,15689,1300,5856,13469,36314
m,u,1937,14390,1151214,385757,28104,75084,189200,678145
m,m,1976,21171,1748540,664109,41652,111322,303840,1120923
m,f,1952,6339,578891,217389,16152,39722,100546,373809
f,m,1880,2493,463707,69812,6096,17828,49185,142921
m,m,2006,21417,1211161,611774,39106,104473,285940,1041293
m,f,1926,3426,281914,95574,7385,19426,48311,170696
u,u,2011,65,485,63,2,16,3,84
f,m,1863,717,110691,18946,1873,5432,14877,41128
m,u,1839,559,81659,10325,729,3462,7474,21990
f,u,1971,9567,632948,270012,21104,53408,154152,498676
m,u,1900,2091,219207,40685,3112,9870,22989,76656
u,u,2013,0,0,0,0,0,0,0
f,f,1837,413,92468,13979,1223,4129,13377,32708
f,m,1952,5956,673761,236742,17197,43520,119013,416472
u,u,1979,19820,396061,105909,7069,21740,21793,156511
f,m,1926,4243,573404,177135,14097,35295,101685,328212
u,f,1988,7298,231430,61513,3813,10610,14121,90057
u,f,1962,3007,46769,15414,1032,3489,2931,22866
u,u,1950,15785,405381,89004,5777,18654,17148,130583
u,u,1945,9113,212375,47534,3270,10043,9000,69847
f,m,1830,633,108653,13445,1129,4642,14155,33371
f,u,1824,79,12647,3542,324,1293,3192,8351
m,u,2003,25943,1407342,593805,41644,112526,292982,1040957
f,m,1911,4997,921785,174214,13663,38479,104288,330644
u,m,1870,2055,64304,7496,660,2304,1359,11819
u,f,1849,545,14855,1487,135,454,495,2571
u,m,1836,1175,41697,3303,288,1123,682,5396
f,f,2004,6161,631048,317615,21782,52819,170214,562430
f,f,1820,379,61021,18881,1319,5939,14673,40812
m,m,1904,11229,1320073,258723,19797,59626,136682,474828
u,m,1994,10118,172668,51622,3447,10215,11625,76909
u,f,1980,4961,125139,33662,2299,6338,7815,50114
u,m,1813,68,518,120,10,63,37,230
u,f,1884,2065,53072,7100,696,2082,1775,11653
f,u,1918,589,91659,19327,1466,4623,11481,36897
m,u,1869,346,40046,8782,779,2191,6350,18102
u,m,1959,10597,251594,61082,3599,11495,11226,87402
f,m,1945,4255,417967,157935,11910,28597,76985,275427
u,u,1845,270,9368,941,70,292,149,1452
f,u,1834,130,22784,2610,194,751,2486,6041
f,f,1883,2708,541068,111203,10587,25344,79845,226979
f,f,1964,2523,262897,113814,8730,19550,54560,196654
m,u,1889,940,90266,19693,1718,4802,12343,38556
u,m,1900,5314,151659,19663,1580,5739,4276,31258
m,m,1928,15516,1489945,456790,33209,91829,234063,815891
f,u,1852,213,47172,6725,540,2016,5029,14310
m,m,1939,12586,1259266,394275,26887,71198,179897,672257
f,m,1836,772,128576,14018,1207,4353,13258,32836
u,m,1954,9132,166418,44623,2940,8539,8344,64446
u,f,1989,6697,261232,55520,3260,9762,13529,82071
u,u,2009,4823,51719,22645,1653,4535,5056,33889
f,m,1842,647,153841,24477,1813,7378,19776,53444
u,u,2008,12064,167654,66272,4612,12982,14056,97922
m,u,1953,21365,1422906,503740,36037,96792,247615,884184
m,f,1924,2696,222108,75982,6012,16001,40337,138332
m,f,1945,6228,748163,220469,15629,38696,94891,369685
u,f,2008,5302,66116,33034,2350,6683,8222,50289
f,u,1844,135,22813,4484,294,1334,4267,10379
f,m,1959,5933,605192,209590,14425,36960,104809,365784
m,u,2008,18845,887209,468960,33750,89994,225992,818696
m,f,1811,169,8219,3471,242,1124,2989,7826
u,u,1859,243,4126,511,62,172,112,857
f,m,1943,4013,440146,146337,10528,26797,70369,254031
u,m,1904,5371,118770,19660,1559,5447,3765,30431
u,f,1859,491,10162,1686,110,438,346,2580
f,f,1945,3281,511571,172023,12197,29519,90720,304459
f,f,1844,690,172610,23179,2128,6823,19438,51568
u,m,1888,5211,177230,18000,1558,5268,4071,28897
u,u,1801,8,6,4,4,4,1,13
f,f,1802,149,23211,4420,468,1715,4354,10957
f,m,1831,817,162248,17339,1370,5238,16476,40423
m,m,1840,3646,499887,69976,5408,20886,49672,145942
f,u,1965,9391,714586,293283,23266,58628,160563,535740
u,f,1898,2726,87942,10269,913,2614,2443,16239
m,m,1892,11604,1357728,250676,21361,61284,145845,479166
m,u,1976,33946,2043804,786523,57963,154822,384668,1383976
m,f,1990,12761,1078845,398843,28367,74649,184438,686297
m,u,1951,19726,1674176,637667,47205,124062,311346,1120280
f,u,1858,726,118661,21198,1938,4941,15906,43983
m,m,1960,17869,1557540,571158,38692,98834,245811,954495
m,f,1939,4223,441626,148086,10495,27510,68130,254221
f,f,1950,3158,482171,186451,12856,31040,91746,322093
m,f,2009,6280,235689,213100,14912,39841,100105,367958
u,u,1964,18644,342401,97546,6609,20406,19170,143731
f,f,1903,2515,492192,99870,7567,21008,64115,192560
m,f,1966,5208,505229,177389,12701,31384,75667,297141
m,f,1931,4951,538336,182666,14558,36488,89162,322874
u,m,1908,5189,142263,23082,1787,5743,4606,35218
f,u,1940,3769,418325,148716,10748,26771,75500,261735
u,u,1817,55,960,158,25,72,52,307
u,f,1801,104,1310,259,24,79,71,433
m,f,1938,6564,638030,202267,16598,40973,96271,356109
m,m,1802,19,1725,460,26,133,483,1102
u,u,1812,44,2063,120,16,50,40,226
u,u,1994,24447,387507,125151,9302,26641,28707,189801
f,u,1976,11632,935559,359754,27454,70057,200427,657692
u,u,1898,434,7682,1009,124,340,299,1772
u,u,1997,21982,419628,112988,8087,22697,24382,168154
u,u,1871,181,2973,410,33,145,93,681
f,f,1939,2109,294853,108296,7788,18974,55794,190852
m,m,1967,22646,1838986,757591,49741,131261,333103,1271696
f,f,1860,1497,305929,52524,4628,13386,40342,110880
f,m,1890,3302,612107,108385,9554,27024,75039,220002
f,m,1857,1583,251202,36927,3087,11346,31265,82625
m,f,1985,10253,924517,333971,23011,60164,156674,573820
m,m,1938,12984,1282606,423529,29791,77802,196737,727859
m,m,1974,21690,1615161,643318,41754,110036,292008,1087116
u,f,1928,2297,51158,11760,938,2904,2623,18225
u,m,1962,9390,153473,46142,2905,9064,8403,66514
f,u,1911,858,126899,23476,1958,5589,15251,46274
m,u,1977,30572,1753266,732685,52453,140615,354140,1279893
f,m,1824,478,53262,8017,702,2654,7853,19226
u,u,1939,7657,197813,38557,2747,8525,8135,57964
u,m,1983,12246,373372,85454,4889,15396,17490,123229
f,f,1857,1376,340602,61142,5499,16420,48377,131438
f,u,1926,5813,569878,196823,16174,43229,119684,375910
m,u,1853,587,69493,11109,984,3218,7505,22816
m,m,1921,15303,2168130,495687,35462,103020,258708,892877
f,f,1933,2453,322284,127292,9640,22536,71258,230726
f,u,1863,326,69882,11286,1057,2767,8797,23907
u,m,1957,8489,174637,43417,2937,8366,8451,63171
f,u,1960,8727,745445,311540,22929,60104,167970,562543
u,m,1961,11239,207140,57252,3645,10957,11022,82876
u,u,1857,353,9297,949,94,302,181,1526
f,u,2014,0,0,0,0,0,0,0
m,u,1916,2172,232409,52793,4035,11982,29020,97830
f,m,1807,75,8958,1528,120,516,1700,3864
f,m,1931,3974,464069,152535,11247,30544,84122,278448
u,m,1919,6844,159759,27712,2245,6845,6071,42873
f,m,1938,3909,402875,146451,11157,27594,72894,258096
m,m,1957,16598,1676944,588369,37083,97634,246319,969405
m,f,1892,5119,678083,129856,12037,30680,75628,248201
f,f,1850,806,264594,39052,3374,10915,31702,85043
u,u,1928,11609,192622,49184,3571,12949,9714,75418
m,f,1888,3927,479235,96408,8877,23627,55801,184713
u,u,1948,12771,262875,62512,4476,14229,11835,93052
m,u,1930,17847,1494302,501983,36616,110298,266931,915828
m,u,1831,303,26813,4925,469,1536,4102,11032
f,m,1933,4686,490729,172119,14110,34223,95053,315505
m,m,1930,16945,1753568,532561,39329,105055,270273,947218
f,u,2013,0,0,0,0,0,0,0
u,u,2012,0,0,0,0,0,0,0
m,m,1990,28393,2554295,923800,58202,156205,413440,1551647
f,f,1948,3085,496111,180432,13420,30966,91980,316798
m,f,1852,1655,273871,40058,3370,10195,27507,81130
f,u,1963,8068,717790,267177,19716,51360,148647,486900
u,f,1935,2866,60265,16827,1313,3776,3403,25319
u,f,1818,292,9779,1223,119,429,433,2204
f,f,2013,0,0,0,0,0,0,0
f,f,1897,3352,673536,126772,11096,27604,89006,254478
u,u,1899,825,29094,3670,262,799,691,5422
u,f,1996,6616,111440,33497,2230,6713,8209,50649
m,m,1801,541,48842,7714,675,2731,6195,17315
m,m,1813,125,6530,974,73,399,500,1946
f,m,1878,1984,240398,47630,4382,12418,35313,99743
u,m,1941,6113,122449,29438,2132,6478,6707,44755
f,f,1812,356,82106,14215,1281,5020,12626,33142
u,u,1896,508,10392,1499,108,407,348,2362
u,m,1923,6671,127846,32014,2409,7927,7162,49512
u,f,1805,74,1479,260,15,99,37,411
f,u,1889,402,60680,11946,1070,2895,9755,25666
f,m,1906,3986,621444,135412,10124,29745,83478,258759
m,u,1942,13322,1036075,351517,24803,64053,161670,602043
f,m,1827,460,56630,7985,836,2897,8129,19847
f,f,1909,3438,733658,136532,10482,29062,83516,259592
m,m,2008,17428,965785,569631,36162,96795,263059,965647
m,f,1835,2638,351867,56949,5040,15716,40937,118642
f,m,1833,633,89077,10962,976,3607,10308,25853
m,m,1823,1954,227936,29721,2642,9313,23786,65462
m,m,1810,575,39430,11788,1074,3799,9320,25981
f,u,1938,4144,436292,171009,11955,30746,92539,306249
f,u,1861,155,19089,3277,249,1008,3576,8110
u,f,1862,520,18686,2414,203,691,627,3935
m,u,1967,36120,2316649,890597,65313,180026,446766,1582702
u,f,1910,3069,92790,13306,1110,3482,3321,21219
m,u,1842,207,25510,2881,262,837,2401,6381
m,f,1933,4771,454125,155784,12262,30941,75731,274718
m,u,1922,6512,417608,161685,11622,36625,82902,292834
f,u,1890,406,56546,9872,923,2410,7058,20263
u,m,1878,2810,55290,7936,750,2298,1790,12774
m,u,1827,352,41543,5948,587,1666,4246,12447
m,u,1987,29301,1438044,660448,48259,124002,315422,1148131
f,f,1845,1226,213734,31464,3130,10558,35594,80746
m,f,1899,6699,944394,161415,13692,36393,88787,300287
f,f,1800,184,32416,6557,678,2156,6144,15535
m,m,1983,20728,1875651,698898,43372,117403,308023,1167696
m,m,2004,23201,1441365,694639,43978,117037,317339,1172993
f,u,1912,687,93255,20644,1684,4659,13149,40136
u,u,1905,950,40183,4718,346,1195,1024,7283
f,u,1908,714,164079,29717,2150,6529,19481,57877
m,u,1943,14784,1018807,380957,26939,68578,173951,650425
u,u,1870,185,8867,604,53,159,209,1025
f,m,1947,6662,776519,252508,18979,45616,126038,443141
u,f,1908,2780,78350,10936,828,2636,2364,16764
m,m,2007,20398,1223483,636475,41246,105852,287985,1071558
f,m,1812,128,13662,1790,140,686,1516,4132
u,f,1854,702,15173,1874,214,635,380,3103
f,f,1896,3553,733162,127176,11188,28343,87142,253849
u,m,1990,15730,340832,88539,5022,15539,18605,127705
f,f,1905,2399,462086,90575,6632,18574,56414,172195
u,u,1965,20442,348042,103898,7110,22377,20970,154355
f,m,1893,3909,619310,110580,9579,28823,72605,221587
f,f,1856,1494,389974,59110,5207,15229,48627,128173
m,m,1915,13157,1977187,401692,27540,86565,198865,714662
u,m,1948,7741,187696,40591,2716,8151,8504,59962
f,u,1931,6029,516690,208057,17502,44060,125575,395194
m,f,1827,1287,196748,29328,2073,8944,21390,61735
m,u,1957,22454,1813784,637670,47614,121244,299581,1106109
u,u,1922,4410,71855,19793,1617,5235,4613,31258
f,f,1801,149,19969,2819,267,1275,3439,7800
u,u,1921,1196,27816,5143,399,1231,1066,7839
m,m,1848,3049,448239,57364,4442,16217,41512,119535
m,m,1878,5793,617741,108857,9693,29178,69541,217269
u,u,1933,7562,125943,31898,2496,7733,6615,48742
u,f,1847,562,13221,1300,109,448,287,2144
f,m,2012,0,0,0,0,0,0,0
f,f,1899,3935,881501,154890,12821,33961,103969,305641
f,f,1840,750,192767,27277,2305,8669,23641,61892
m,u,1894,698,77432,17478,1621,3808,10476,33383
m,m,1861,1622,238577,37435,3092,9647,22821,72995
m,m,1885,7555,901789,154782,13670,39135,92579,300166
f,f,1921,3520,907373,199161,15069,40239,113899,368368
f,f,2014,0,0,0,0,0,0,0
u,f,1888,1782,55972,7422,756,2202,1995,12375
m,u,1968,41159,2263262,907409,66486,187969,448564,1610428
m,m,1868,3216,482537,84331,7035,22723,49164,163253
u,f,1950,2978,57946,16372,1284,3344,3388,24388
u,f,1973,3054,54171,17143,1223,3372,3967,25705
m,f,1866,2553,420225,66912,6315,17197,42525,132949
m,m,1948,17257,1782021,608143,40882,103290,269175,1021490
u,u,1916,1397,57774,8274,583,2456,1528,12841
f,f,1926,2028,282624,98113,7535,19372,61215,186235
m,u,1826,173,8186,2795,194,1040,2153,6182
m,f,1947,6685,689575,223839,16514,39663,99780,379796
m,u,1984,29738,1483764,667184,48517,125116,320950,1161767
m,u,1944,12109,788529,277237,19821,51005,133070,481133
m,f,1949,6228,647201,207174,15054,37286,93776,353290
f,f,1915,4381,1034485,203301,14831,41118,124784,384034
f,f,1916,3715,936272,183805,13758,36715,106198,340476
f,f,1927,2086,328046,113074,8830,21219,66054,209177
f,m,2014,0,0,0,0,0,0,0
f,m,1800,85,17294,2222,150,806,1846,5024
m,u,2014,0,0,0,0,0,0,0
m,u,1824,191,16067,3729,320,1087,2437,7573
u,u,1996,23157,374546,111638,7635,23634,26609,169516
f,m,2000,7512,603195,277033,18033,47792,145205,488063
u,m,1840,1856,38220,3935,341,1557,703,6536
m,u,1990,39633,2084983,886373,64394,167003,446812,1564582
f,f,2008,5956,447039,337269,21727,55855,179166,594017
f,u,1945,5490,532036,185282,13695,32947,96362,328286
u,f,1944,2870,70526,14637,1120,3192,3251,22200
u,f,1842,551,16665,2139,180,771,387,3477
m,u,1992,40127,2025211,936444,67811,178594,464426,1647275
m,f,2002,11560,793263,360722,25565,63817,164036,614140
u,u,1816,76,2033,132,19,52,36,239
m,m,1897,12091,1482870,280853,21421,65008,153925,521207
u,f,1874,958,29595,3741,327,1073,981,6122
f,f,1807,206,27869,8288,523,3132,9283,21226
u,u,1873,221,1259,243,41,98,62,444
u,m,1849,1310,35927,4003,306,1422,778,6509
u,f,1903,2048,54027,8443,664,2022,1948,13077
f,m,1838,514,80664,11488,994,3763,10719,26964
u,m,2012,0,0,0,0,0,0,0
u,m,1906,5265,142112,20863,1699,5610,4541,32713
f,u,1830,522,64947,6946,733,2386,7155,17220
u,f,1872,1133,34017,3404,334,1218,964,5920
u,u,2014,0,0,0,0,0,0,0
u,m,1816,142,6743,394,50,157,88,689
m,m,1919,13676,2074411,447783,32079,94527,221565,795954
u,f,1964,2691,42560,15984,1221,3118,3656,23979
u,u,1849,151,2664,260,16,78,53,407
f,u,1870,182,39548,5786,474,1471,4838,12569
f,u,1836,111,7886,1541,186,481,1523,3731
m,m,1899,21010,2490966,441120,34337,107114,252899,835470
u,f,1809,279,7101,950,79,328,247,1604
m,f,1877,2650,333258,63964,6040,15937,39563,125504
f,m,1965,6459,522298,201585,13900,36368,101535,353388
m,m,1895,14453,1825748,323078,24871,79721,183707,611377
u,m,1937,8008,131756,31605,2408,7203,6690,47906
f,u,1989,14407,868994,436741,31200,79660,242642,790243
f,m,1834,646,154450,15442,1291,4779,14212,35724
f,f,1849,528,106843,17469,1422,4901,15605,39397
f,u,1959,6990,559735,202068,15569,40621,117640,375898
u,f,1883,2208,57139,7691,779,2293,2017,12780
m,f,1922,8467,1024500,243842,19530,52402,121893,437667
u,u,2004,20225,319394,106672,7818,22743,25236,162469
m,m,1891,9245,1069290,202661,17820,48612,116316,385409
m,m,1838,1608,198185,26978,2154,8227,20537,57896
u,u,1903,1175,23957,3544,328,986,788,5646
m,f,1842,1139,132755,21412,1955,6337,15976,45680
m,f,2000,11215,721800,375461,27469,68486,171978,643394
u,f,1802,51,8060,401,37,187,102,727
f,m,1916,4159,777976,169701,13066,36674,95176,314617
u,m,1974,11654,204510,58426,3732,11876,11541,85575
m,m,2012,0,0,0,0,0,0,0
f,m,1972,5504,416257,174988,12394,32874,89353,309609
m,u,1801,27,5024,798,80,274,565,1717
u,m,1916,6198,158589,25005,1961,6540,5973,39479
u,m,1844,2249,69340,5557,503,2109,1016,9185
u,m,1881,2733,72121,9507,857,2869,1970,15203
f,f,1965,2507,295962,119273,8665,21454,59147,208539
u,m,1950,10566,290288,64060,3600,12098,12522,92280
u,m,1838,640,23024,1953,160,655,365,3133
u,f,1969,2880,48692,15789,1002,2974,3312,23077
m,f,1809,453,78383,12775,1083,4156,9333,27347
m,f,1858,1752,283221,47666,3882,12317,31463,95328
u,m,1997,13438,210296,65919,4485,13359,15555,99318
u,u,1915,1245,45856,6864,556,1580,1313,10313
f,m,1874,1066,181957,35500,3327,9445,25188,73460
m,m,1855,3075,421225,59643,4468,16431,38570,119112
f,u,1941,4422,518327,167462,12063,29173,91602,300300
m,u,1904,1819,189206,40178,3372,9240,21057,73847
m,u,1855,926,100761,17273,1605,4938,12019,35835
f,m,1976,6052,552082,224577,15010,39632,114386,393605
u,m,1944,5717,82169,23479,1739,5290,4546,35054
f,m,1944,3187,323525,118635,8573,21917,58392,207517
f,u,1943,4618,438786,158074,11701,28504,80492,278771
m,u,1946,23870,1766578,618137,45559,114795,299500,1077991
m,f,1882,4058,530137,102289,8603,24798,55792,191482
f,m,1862,640,86098,14669,1301,4150,12227,32347
u,m,1914,6459,173499,24485,2010,6850,5475,38820
m,u,2001,26592,1392833,603275,42154,111600,302125,1059154
f,m,1949,5291,572439,193582,14566,36130,99329,343607
f,u,1884,222,28630,7057,734,1775,4292,13858
m,f,1903,4415,469609,103660,8316,23261,56326,191563
m,m,1917,12197,1570123,351870,24872,73938,178450,629130
m,f,1851,1471,172641,28880,2877,8590,21479,61826
m,u,1917,2043,241814,49218,4073,11585,25801,90677
f,f,1846,650,170315,24161,2103,7136,20396,53796
m,u,1975,29286,1673322,665040,50249,133032,329420,1177741
f,u,1840,87,7872,856,80,323,1064,2323
m,u,1941,11622,924011,321151,22345,64071,161093,568660
m,f,1944,6459,754455,215026,15588,39917,99704,370235
f,u,1905,812,111444,21127,1704,5499,14211,42541
f,m,1865,1125,203916,31095,2580,8498,22481,64654
f,f,1998,6134,610120,322774,21475,52788,179769,576806
m,f,1810,648,92398,19217,1220,6468,16549,43454
f,u,2008,7700,471965,264597,19419,49817,145453,479286
m,u,1811,131,17825,3845,284,1110,3548,8787
m,m,1833,2252,304036,32796,2677,9686,25857,71016
f,u,1809,17,519,245,30,87,215,577
m,u,1886,1028,103534,19542,1825,5183,12916,39466
m,u,1911,2253,237689,43797,3231,10612,21751,79391
u,f,1899,3088,96652,13248,1206,3542,3393,21389
m,m,1875,2844,429864,74354,6399,18884,44568,144205
f,u,1841,63,6884,1557,116,443,1310,3426
u,u,1861,222,4693,783,69,225,134,1211
m,m,1832,1417,266310,34163,2905,10418,26025,73511
u,f,1817,288,12983,1673,114,591,471,2849
f,u,1859,293,34259,7911,672,2069,6441,17093
m,m,1829,4431,678530,65299,5210,18691,55299,144499
u,u,2007,21367,373658,123653,7905,24676,27566,183800
u,u,1838,105,2701,175,17,44,42,278
u,m,1913,6674,179210,26464,2037,7267,5686,41454
u,f,1866,1143,41050,3428,417,1076,849,5770
m,m,1867,2877,447927,70959,6528,18587,43057,139131
f,m,1840,883,107969,19533,1665,6553,16763,44514
f,u,1868,558,125450,24110,1848,5977,16909,48844
u,u,1807,55,591,118,15,43,25,201
f,u,1956,7544,759415,280109,21398,54960,151655,508122
f,u,1886,441,62876,12924,1263,3343,10632,28162
u,m,1971,11460,179387,52405,3601,10461,10475,76942
m,m,1890,10138,1462443,229409,18901,56696,140192,445198
u,f,1927,1850,36640,9181,852,2325,2443,14801
f,m,1882,2178,332691,71553,6503,17880,50396,146332
f,m,1894,4180,678967,122714,9826,30107,78864,241511
m,u,1804,20,1057,677,43,229,689,1638
m,u,1891,1004,107124,20983,1857,5421,13663,41924
u,f,1893,2976,98833,11446,1068,3191,2875,18580
m,m,1872,7274,1085928,140704,11567,38796,84872,275939
f,f,1988,6610,933914,369013,23267,58707,194844,645831
u,u,1966,20326,412325,109782,7302,23058,23312,163454
m,f,1800,245,18337,4947,503,1450,3370,10270
m,u,1972,27408,1753477,656436,47619,126073,318277,1148405
u,m,1875,1484,52271,5637,526,1669,1276,9108
f,f,1888,2313,482808,90168,8328,21837,64341,184674
u,m,1845,1112,41141,3532,283,1128,608,5551
m,m,1806,303,32940,4928,436,1537,4265,11166
m,m,1988,27709,2358938,863571,53178,145130,391969,1453848
m,u,1932,13150,962623,323250,23886,66110,169899,583145
m,m,1804,470,32269,6224,575,2166,5061,14026
u,u,1982,21260,406762,108456,7550,22471,22924,161401
u,u,1998,21546,376982,108149,7979,22895,26453,165476
f,m,2007,6719,471889,262203,17793,45450,137933,463379
f,f,1958,2461,344525,118674,8058,19787,60231,206750
f,u,1846,190,39354,4422,439,1604,4237,10702
m,u,1999,30095,1494331,703462,48627,130834,347415,1230338
u,u,1963,18165,387934,98819,6510,20621,19172,145122
m,m,2014,0,0,0,0,0,0,0
u,f,1804,97,5046,317,28,132,33,510
f,u,2010,659,40616,15917,1208,2909,8577,28611
u,m,1998,10323,191918,53728,2984,9887,11842,78441
u,m,1848,1452,43649,3934,325,1449,865,6573
f,f,1900,3119,594080,110425,9039,24813,73547,217824
m,f,1895,5276,681202,125135,10695,30410,67894,234134
u,m,1847,751,39805,3015,249,1083,505,4852
u,f,1961,2914,61658,21834,1518,4480,4251,32083
u,m,1902,4813,119726,17722,1440,4809,3609,27580
f,f,2010,3,0,124,2,17,66,209
f,u,1867,294,57774,10382,786,2413,7245,20826
m,u,1981,32150,1870993,717235,51657,138195,344390,1251477
u,m,1818,290,7175,488,43,197,137,865
f,f,1817,368,95189,13103,1092,4201,13980,32376
u,f,1812,201,3465,691,60,286,212,1249
m,f,1850,1291,213168,30835,2540,8326,21782,63483
f,u,1984,10794,764471,363513,26463,66136,201741,657853
m,m,1816,368,26379,4959,461,1593,4470,11483
m,u,1959,21066,1387921,490150,35554,99255,249114,874073
u,u,1856,196,6135,321,30,125,84,560
u,f,1979,4483,125335,38653,2117,6676,9036,56482
u,m,1889,4600,116948,13195,1179,4020,3200,21594
f,f,1861,840,142632,23671,2350,6405,18694,51120
f,u,1800,5,348,27,0,7,12,46
f,m,1801,168,15717,2440,239,1154,2542,6375
u,f,1955,2397,43897,11876,847,2442,2353,17518
f,m,1875,916,207965,38789,3434,10154,27231,79608
m,f,1855,2170,318550,48625,3782,12893,31411,96711
f,m,1818,196,28378,3216,276,938,2660,7090
m,m,1918,13546,1703548,370462,27161,78750,184088,660461
m,f,1935,6093,508598,179203,14102,35622,88172,317099
f,f,1859,915,169490,28534,2507,7417,24749,63207
f,f,1876,2021,463530,81434,7431,19348,58371,166584
f,f,1862,864,183082,29364,2781,7797,23266,63208
m,m,1834,2720,494168,46523,3458,13722,37627,101330
f,u,1995,13155,926417,393856,27973,74359,226960,723148
m,f,1979,8266,696489,256950,18276,46512,117143,438881
m,m,1968,25005,1955722,783539,52768,134094,339955,1310356
f,f,1869,1576,361707,67474,6367,15757,49079,138677
f,m,1960,5787,508224,198921,15082,36937,100175,351115
m,u,1830,1415,237543,24984,2187,8284,20414,55869
m,u,1819,169,29894,4306,330,1552,3170,9358
m,u,1815,268,17470,3474,272,1098,2595,7439
u,f,1850,529,17451,1648,163,540,397,2748
u,u,1894,368,6101,1144,142,393,233,1912
m,m,1830,2228,306474,38503,3046,11963,32789,86301
m,u,1812,93,11828,1978,191,643,1794,4606
m,m,1844,4451,817965,97356,6762,31352,67951,203421
m,m,1958,17476,1823336,644683,42037,109747,273013,1069480
m,f,1839,970,115153,16948,1370,4894,13571,36783
u,u,1935,8074,169163,41779,3113,8980,9191,63063
f,f,1953,2878,411957,151872,10212,25242,75172,262498
u,f,1931,2700,57301,17173,1351,3879,3745,26148
u,m,1953,8972,204315,50120,3364,10157,9561,73202
u,f,1951,2899,62023,16307,1205,3404,3079,23995
m,m,1837,2255,411025,50456,4033,14820,37612,106921
m,u,1848,317,38865,5311,452,1619,4203,11585
u,f,2009,2942,34810,20395,1235,3837,4592,30059
m,u,1874,393,49669,8199,701,2185,5404,16489
u,m,1879,1135,32259,3411,319,1030,750,5510
u,m,1805,106,2667,510,45,203,120,878
f,f,1963,2510,302996,129814,8958,22035,64801,225608
m,f,1955,5806,556757,191225,13297,34844,85592,324958
f,u,1842,80,9033,1277,101,386,1260,3024
u,u,1951,11232,225697,59171,4178,12670,11844,87863
f,f,2012,0,0,0,0,0,0,0
m,u,1925,12967,1000318,324575,25010,73253,180752,603590
u,f,1990,6687,197917,49162,3255,8779,11814,73010
m,u,1890,989,82617,16656,1507,4197,10215,32575
m,m,1973,21826,1653278,665902,42939,110510,303505,1122856
f,f,1816,266,97949,12396,956,4299,10485,28136
m,u,1973,25512,1242002,577189,43361,115015,285756,1021321
m,f,1828,454,101560,12816,1062,4138,9634,27650
u,u,1884,230,4869,671,101,218,106,1096
u,u,1897,393,19924,1606,129,323,364,2422
f,u,1962,9376,841440,312346,23479,59167,167684,562676
f,m,1851,673,115272,17417,1406,5543,13731,38097
f,m,1869,1316,189637,34205,3417,9136,24187,70945
m,m,1849,2575,303557,44770,3719,13138,31530,93157
m,f,1836,1074,168288,24144,2089,7358,17473,51064
u,u,1811,109,8015,581,41,199,89,910
m,f,1859,1316,189716,30607,2780,8336,21716,63439
f,f,1982,4459,748937,286807,18379,45166,148709,499061
m,f,1969,5898,525769,193493,13749,34589,85148,326979
u,f,1832,478,16167,1176,117,453,352,2098
f,m,1996,6188,499982,225903,14546,37753,122132,400334
u,m,1960,9271,176730,48406,3055,9554,9187,70202
f,u,1961,9217,816153,323295,24360,60303,180333,588291
f,m,1971,6254,434919,191411,13917,35615,100734,341677
m,f,2008,11614,578738,392420,27733,73406,185591,679150
u,u,1909,951,32869,4444,346,1113,778,6681
u,f,1924,1291,23334,5741,450,1348,1396,8935
m,u,1931,16129,1224822,426355,32199,88043,223087,769684
f,f,1811,120,37586,7987,563,2586,7257,18393
f,f,1892,3366,756468,150241,13936,34096,103254,301527
m,u,1938,13245,894339,355015,25911,68509,178320,627755
u,f,1865,1202,41646,4197,417,1309,1118,7041
m,f,1885,3453,522198,97702,8903,24040,53784,184429
f,u,1977,10933,875672,365799,27094,69671,197164,659728
f,m,1951,6157,643970,236950,16931,43970,119227,417078
u,u,1875,203,2653,576,55,191,132,954
m,f,1802,138,17685,3189,316,1031,2500,7036
u,u,1900,916,24781,3577,268,1137,838,5820
u,u,1813,4,25,4,0,2,4,10
f,f,1873,1755,442768,76078,6890,18184,55570,156722
u,f,1820,266,9505,1686,117,602,344,2749
f,f,1936,3905,590652,204364,16011,38168,116479,375022
u,f,1957,2603,64001,18891,1402,3716,3794,27803
m,f,1943,5721,620549,195326,14421,36097,87704,333548
m,f,1883,4793,536295,113198,11066,27852,64502,216618
m,f,1876,3015,465338,84220,7551,21071,50387,163229
m,f,1929,4848,449989,150625,11959,30738,80157,273479
m,f,1829,902,139395,15839,1440,4975,12801,35055
m,m,1996,20472,1461537,622904,38346,105103,285459,1051812
m,f,1872,2825,384462,65152,6173,16549,39745,127619
u,m,1963,9968,156749,50962,3406,10130,9808,74306
f,u,1849,163,14220,2885,271,843,2454,6453
u,m,1927,8103,194427,35760,2692,9034,8144,55630
m,m,1962,19374,1710155,621055,40876,105545,258839,1026315
u,m,1930,8719,171083,39513,2838,9239,8277,59867
u,m,1831,1839,72227,4320,333,1394,1036,7083
m,f,1964,4827,368418,154531,11314,27679,66281,259805
f,m,1929,5669,618253,211945,16386,43389,120545,392265
m,f,1898,6101,723766,137093,12014,31963,80125,261195
m,m,1935,17707,1653379,554578,40622,103520,270123,968843
u,f,1959,2642,96059,21203,1379,4001,4273,30856
m,f,1988,12994,1297732,440789,30252,79390,208171,758602
m,f,1967,4832,360640,150065,11294,27984,67550,256893
f,m,1954,6037,636309,232270,16953,41830,116282,407335
m,m,1951,18188,1965822,666161,44547,114957,290032,1115697
f,m,1999,6054,479994,247732,16245,41904,131421,437302
u,m,1993,9851,121576,44159,3186,9122,10275,66742
m,f,1987,10909,1026791,360681,25054,65321,169003,620059
m,m,1998,20513,1389340,623174,39109,104668,296267,1063218
m,u,1850,51,5744,563,45,147,438,1193
f,f,1991,5569,550991,290023,20079,48353,150320,508775
f,u,1864,449,72127,11189,1030,2594,8257,23070
u,u,1808,36,347,76,11,23,20,130
u,u,1958,13932,322994,92004,5930,18117,17766,133817
f,m,1967,6863,569943,249454,17660,45714,127373,440201
u,u,1952,12995,343233,76846,5169,16627,15495,114137
m,u,1923,14136,1080064,339114,24976,76592,189786,630468
m,f,1832,1307,168457,28501,2485,7924,21267,60177
m,m,1884,7505,832118,162312,14337,41127,97086,314862
m,u,1808,126,13476,1724,175,573,1251,3723
m,m,1888,8905,1231033,211441,16720,52661,126037,406859
m,f,1989,12953,1257026,448940,30253,79745,204499,763437
f,m,1873,1075,210643,34011,3059,9367,25346,71783
f,m,1883,4353,629401,119449,11337,31062,84892,246740
f,m,1899,5722,888276,160339,13018,38659,108587,320603
u,f,1834,438,16563,1383,111,470,322,2286
f,f,1884,2328,453298,95430,9219,22137,66958,193744
f,u,1970,12950,1091946,411648,31073,81892,235158,759771
m,f,1869,2584,352962,61415,5743,15715,36977,119850
m,u,1885,605,57692,10177,970,2688,6229,20064
m,m,1889,8461,991808,168200,14189,41200,99300,322889
m,f,1801,205,18582,4908,401,1693,3963,10965
u,u,1969,23963,400669,109682,8209,24011,22677,164579
m,f,1874,2346,354573,62444,5594,15812,34457,118307
u,f,1830,314,14831,929,102,364,252,1647
u,f,1837,311,10048,782,74,275,232,1363
f,f,1979,4186,524132,225092,16794,40161,121701,403748
f,m,1988,8221,739854,299302,19154,51954,158579,528989
m,u,1803,149,16096,2956,232,1113,2297,6598
m,m,1913,15497,2410314,467225,32522,102506,229258,831511
u,f,1838,585,17158,1136,142,528,348,2154
f,m,1937,5417,607669,216452,16433,39374,107777,380036
m,m,1908,11461,1708289,352236,25105,76124,183422,636887
u,m,1943,7145,146732,34365,2403,7379,5836,49983
m,m,1820,689,68529,9665,762,2873,7096,20396
u,f,1915,3291,79787,13710,1105,3660,3219,21694
m,m,1811,448,43042,8508,634,2705,6910,18757
f,u,1877,213,30050,5320,478,1347,3895,11040
f,m,1993,6262,438584,218943,14604,38512,112266,384325
u,f,1863,722,16075,1948,182,606,434,3170
m,u,1866,319,34734,6165,659,1653,3725,12202
u,f,1879,995,32426,4017,416,1146,1008,6587
m,u,1876,825,105422,14514,1313,3867,10135,29829
m,f,1870,2237,312911,60346,5525,15037,35000,115908
u,f,1892,2304,75919,9353,878,2790,2389,15410
u,m,1958,9115,181396,51108,3905,10563,9698,75274
f,f,1880,2295,453786,106703,9486,25557,78503,220249
f,f,1993,5455,504717,266270,17686,43972,143831,471759
m,f,1934,5969,501447,184204,14482,36822,90266,325774
u,f,2002,5416,78918,27674,1917,5742,6553,41886
m,u,1845,414,64725,6385,451,2039,5113,13988
f,u,1946,7523,636785,249955,19675,46939,135834,452403
m,m,1822,662,74650,10057,803,2879,7567,21306
f,m,1887,2600,438642,82999,7685,19896,56384,166964
m,u,1956,21528,1750369,632183,44930,120002,301408,1098523
f,f,1907,3039,669300,133581,10135,26501,81133,251350
u,m,1811,198,6751,494,48,204,117,863
m,f,1973,6231,455877,184267,14100,34750,86724,319841
f,m,1885,2325,406718,73422,6378,18197,50471,148468
f,m,1860,1039,165364,26791,2399,7885,23196,60271
m,f,1830,787,116640,15616,1340,4395,12652,34003
f,m,2003,7098,588782,272212,17851,46566,141917,478546
u,u,1993,25926,396649,136256,9792,27862,31427,205337
m,u,1820,141,18077,2703,229,756,2037,5725
m,m,1869,3983,395809,67582,6409,18726,43724,136441
f,m,1907,3618,608606,114440,8662,25359,70130,218591
u,f,1995,5608,86640,28634,1988,6042,7062,43726
f,u,1880,369,43970,8689,832,2059,6778,18358
f,m,1950,6208,729239,238056,16516,42877,119813,417262
m,f,1864,2550,386988,60096,5258,16046,36508,117908
f,f,1920,4303,932988,208708,15515,41779,120910,386912
m,f,1840,1140,186845,27086,2349,8764,21150,59349
u,f,1891,2373,69483,8260,732,2399,1991,13382
u,m,1887,4453,137734,17029,1458,4464,3559,26510
f,m,1973,6654,473918,195024,14170,36139,99604,344937
m,m,1857,4740,800850,98283,7849,27795,67089,201016
u,u,1854,432,16969,1336,108,481,308,2233
u,m,1832,881,45011,3218,236,1071,777,5302
u,f,2012,0,0,0,0,0,0,0
f,m,1825,759,119329,15358,1306,5132,15089,36885
u,m,2003,10778,146451,54111,3713,11227,12005,81056
f,m,1992,5862,443596,211505,13988,36054,106823,368370
m,f,1983,6842,509243,235946,17006,42181,107692,402825
m,u,1870,475,78323,12169,1064,3397,7731,24361
u,m,1830,1100,39439,3013,284,1217,651,5165
m,m,1991,21305,1310423,620214,41183,106873,285459,1053729
m,f,1948,5699,607728,213389,15832,39426,94066,362713
u,m,1876,2227,81675,8853,801,2595,1535,13784
m,u,1898,852,98864,17949,1563,4468,10735,34715
f,u,1906,577,79926,18629,1421,4407,11689,36146
u,f,1845,1296,42577,3082,285,1255,857,5479
f,u,1909,562,106488,21326,1619,4687,13641,41273
u,m,1869,2064,46328,4980,489,1494,1172,8135
f,m,1983,5969,529267,223328,14895,38935,114696,391854
f,m,1854,1183,155498,22168,1976,6589,19167,49900
u,u,1876,346,10950,1170,127,387,330,2014
u,m,1992,9171,121028,41413,2942,8493,9253,62101
u,u,1907,826,21287,3783,281,809,766,5639
u,u,1827,202,4686,503,45,215,113,876
m,f,1976,6590,532611,199464,14981,36083,83958,334486
u,m,1939,6413,148699,30481,2153,6453,6371,45458
u,f,1870,987,29618,3188,295,941,901,5325
u,u,1831,126,5322,289,32,101,49,471
m,m,1953,17415,1822384,603145,39778,104715,268698,1016336
f,u,1900,781,96029,19958,1681,4497,13093,39229
m,u,1965,28887,1820545,741936,53678,142235,358599,1296448
f,f,1904,2327,460938,82729,6033,17916,54549,161227
f,f,1902,2256,434692,81603,6728,17840,52913,159084
u,m,1907,5347,165584,22540,1568,6051,4682,34841
f,u,1807,47,3851,954,126,355,1096,2531
u,u,2010,1075,10242,4843,347,1026,836,7052
m,m,1923,13633,1435590,440975,32370,88790,236002,798137
f,u,1853,305,52368,8364,705,2427,6792,18288
u,u,1904,1016,29970,4208,342,1167,847,6564
f,f,1910,3694,780399,152682,11956,31552,97061,293251
u,m,2005,11146,148998,55477,3982,11534,12690,83683
u,u,1868,437,6698,1345,124,450,195,2114
f,u,1902,916,148309,27438,2075,5838,18480,53831
u,m,1871,2028,56688,6727,613,2223,1164,10727
u,u,1822,258,4958,512,37,233,217,999
f,m,1948,5434,608494,213935,15697,39251,110519,379402
u,f,1871,1040,35722,3833,363,1068,868,6132
m,m,1903,10626,1313336,257693,19942,61353,139838,478826
m,m,2001,20925,1188310,580549,37396,99622,269779,987346
f,f,1839,590,108384,17464,1509,5063,16527,40563
u,m,1935,9414,207672,53677,3811,11302,11194,79984
u,f,2005,5769,103778,34109,2363,6427,7699,50598
m,f,1910,6693,835704,164106,13243,35904,87056,300309
u,f,1975,3126,68853,16350,1060,3205,3638,24253
u,u,1908,1501,30427,4780,523,1160,1001,7464
m,f,1923,2608,254107,78387,6031,16043,38482,138943
m,u,1989,35509,1770353,816718,58443,153980,397389,1426530
f,u,1843,106,29208,3386,292,1144,3314,8136
m,f,1953,5660,560647,205565,14791,37671,89517,347544
u,m,1854,1702,41360,3528,354,1223,841,5946
f,f,1835,1695,320639,50629,4867,14156,44586,114238
f,u,1958,5839,522471,205453,14944,39229,112971,372597
m,m,1969,26348,1946826,773187,51293,131505,334826,1290811
f,m,1923,4667,579089,189667,15197,39222,112253,356339
m,u,1875,433,31829,7589,669,2045,4155,14458
m,f,1928,4179,369759,130607,10248,26493,63863,231211
m,m,1910,15985,2233305,432490,30702,98379,221249,782820
u,m,1933,8891,254572,45236,3286,9631,8545,66698
m,u,1883,644,64508,10542,1116,2837,6923,21418
u,u,2002,20421,316713,98703,6815,18989,22696,147203
u,u,1991,25507,436061,136192,9268,28089,29388,202937
u,u,1985,21811,370651,117694,8048,24343,26472,176557
m,f,1986,8507,756453,269920,18937,49324,124548,462729
u,u,1888,413,10913,1457,158,424,422,2461
u,m,1814,30,1026,175,16,59,36,286
m,f,1912,6741,840186,172516,13186,37288,91424,314414
f,f,1868,1455,342499,63425,5401,15533,47231,131590
u,m,1896,9622,310368,32692,2642,9802,6759,51895
f,f,1863,1161,341848,58435,5009,14771,42274,120489
m,m,1880,7089,1047165,162901,13169,43193,102653,321916
u,m,1804,362,9317,737,89,291,134,1251
u,m,2001,10522,164479,54115,3351,10060,11865,79391
m,f,1984,8259,719759,256057,18009,47493,121779,443338
u,m,1977,10498,234522,62153,3915,11173,12794,90035
m,m,1854,3798,433460,60254,5072,17564,43863,126753
u,m,1915,6041,174358,25164,1879,6703,5514,39260
f,u,1805,7,218,60,3,26,86,175
m,m,1846,2893,460326,58198,4203,17881,43183,123465
m,u,1983,37085,1987933,783053,56076,152080,381153,1372362
u,u,1953,12927,279051,68430,4658,15072,14209,102369
f,u,1934,4269,365045,147818,12383,29714,83725,273640
m,m,1828,1272,201049,20992,1678,6999,18236,47905
m,m,1943,14365,1444470,467179,31603,77626,195946,772354
u,f,1814,364,3913,1305,93,483,315,2196
m,f,2004,11320,822186,375053,26223,67125,167960,636361
m,f,1865,2944,408515,70513,6496,18098,43003,138110
u,f,1864,1216,42283,4178,378,1328,1021,6905
u,u,1923,12905,312340,63388,4190,15301,13356,96235
f,m,1820,183,15485,3313,277,1040,3078,7708
u,m,1868,1638,43538,5348,486,1733,1115,8682
f,u,1833,87,10656,2020,174,704,2116,5014
m,u,1961,26590,2046244,757439,53351,146563,388211,1345564
m,m,1997,23590,1773508,752717,47437,131189,350499,1281842
u,m,1886,3378,88394,11279,963,3369,2555,18166
f,f,1951,3308,567390,184653,12655,30557,90738,318603
f,m,1816,65,11422,1511,116,516,1631,3774
u,u,1995,21819,368827,113461,8063,24103,26297,171924
f,f,1906,3036,670224,129427,10200,26656,81502,247785
m,m,1803,305,11096,2274,220,886,1581,4961
f,u,2006,12044,761794,412715,27554,69654,231698,741621
u,f,1890,2808,96944,11075,1072,3460,2529,18136
m,u,1997,32841,1609257,740989,53114,143687,362251,1300041
m,m,2005,20696,1284427,635089,41144,109509,293866,1079608
u,f,1856,890,21216,2790,267,823,795,4675
u,u,2000,19465,308937,100408,6882,20367,22830,150487
u,m,1892,6278,196669,21294,1791,6673,4324,34082
f,m,1921,4934,845019,199393,15551,43061,116916,374921
f,u,1881,329,38540,7036,684,1863,4882,14465
m,f,1917,6544,890237,194882,14835,41482,96580,347779
m,m,1893,13347,1901998,323660,25331,81821,180358,611170
f,u,1925,4458,506519,171445,12795,37149,109123,330512
m,f,1862,1334,189616,32400,2922,9041,18558,62921
f,u,1957,8039,835834,320526,24711,61280,168066,574583
u,u,1862,175,4217,328,39,107,99,573
f,m,1936,4115,503147,171407,12875,32170,93016,309468
f,f,1911,3593,772162,148072,11517,31044,90079,280712
f,m,2001,6796,507387,236689,15727,40822,125605,418843
u,m,1956,9897,168777,46705,3261,9611,8601,68178
f,m,2010,73,4265,3635,264,561,1795,6255
m,f,1921,5542,738425,178333,13765,38380,85849,316327
u,u,1970,25534,462696,125041,8906,27593,25113,186653
f,u,1985,12249,933734,399656,29962,73496,220390,723504
u,u,1869,155,4425,617,50,147,203,1017
m,m,1961,21162,1903978,687913,45755,116032,296644,1146344
m,m,1886,6811,873288,158509,13369,38929,92971,303778
f,m,1917,3982,647215,148582,11609,31588,87452,279231
u,m,1972,9949,184211,52345,3466,10048,11039,76898
f,f,1822,452,89950,14879,1283,4940,13811,34913
f,m,1846,786,125213,17839,1392,5841,14872,39944
m,f,1821,398,61076,13952,1002,4144,12422,31520
m,u,1895,1053,102369,23980,2046,5658,13922,45606
u,f,1844,620,13211,1753,181,627,394,2955
u,f,1824,301,13949,1082,88,431,177,1778
m,m,1944,11566,1014534,350793,24764,61495,155189,592241
f,f,1874,1468,336770,62479,5724,15688,43126,127017
u,u,1826,97,9532,489,49,135,160,833
f,u,1847,77,7969,1420,123,480,1295,3318
m,f,1980,8536,715545,280444,20115,51176,131086,482821
f,f,1841,1075,176169,31855,3001,10462,28920,74238
f,f,1889,3057,701095,130150,11976,29921,91322,263369
f,m,1991,6757,494591,250243,16897,43289,134118,444547
f,m,1910,4641,753648,149511,11463,32872,89800,283646
u,f,1942,2344,52985,12531,996,3014,2907,19448
f,u,1838,89,14606,1929,175,580,1867,4551
u,u,1906,825,15102,2581,236,767,619,4203
u,u,1932,9700,231024,48589,3012,10996,10401,72998
u,f,1932,2010,34653,9854,824,2382,2546,15606
f,u,1898,350,53189,10682,922,2584,7852,22040
m,f,1845,2673,335305,47144,4373,15831,43845,111193
f,u,1968,12191,965476,398964,29389,79701,225711,733765
m,u,1979,31201,1908928,734964,52838,140724,348747,1277273
u,f,1943,2660,80955,16507,1036,3558,3682,24783
f,m,1914,4815,1008726,201803,15348,43123,116730,377004
f,u,1924,4475,468997,160394,12921,33785,96696,303796
u,m,1890,5596,187467,19931,1731,5888,4493,32043
m,m,1871,3265,466008,81054,7020,21039,51167,160280
m,f,1970,7478,541002,208595,15406,38216,88704,350921
f,m,1897,3671,683780,123880,9838,30032,80666,244416
m,f,1936,7034,629237,213282,16984,43219,103241,376726
m,m,1831,3727,560581,56166,4265,16038,46054,122523
f,m,1904,3254,520911,100464,7699,22835,61593,192591
u,u,1947,12111,242541,63045,4437,13683,12256,93421
u,u,1911,1311,20379,4075,370,1166,910,6521
u,m,1883,5597,123198,13191,1209,4124,3145,21669
u,f,1836,384,9188,1304,119,484,307,2214
f,f,1831,381,93755,12986,1131,4057,12014,30188
f,u,1996,14189,922248,416693,31654,78724,237187,764258
f,u,1997,12823,808311,384060,27780,72198,216865,700903
u,m,1922,8531,193825,33048,2598,8381,7340,51367
m,u,1867,637,76002,13992,1063,3739,9293,28087
f,u,1813,33,7042,1787,146,574,1660,4167
f,f,1852,1009,278852,45852,3570,11390,39539,100351
u,f,1918,3006,66233,11862,947,2851,2889,18549
f,m,1997,7582,656184,283574,18307,49281,146821,497983
f,m,1819,203,38757,3815,342,1110,3684,8951
u,m,2000,12501,211327,68850,4651,13864,14705,102070
u,f,1945,2532,76193,17790,1253,3620,3585,26248
u,m,1918,6554,169134,26044,2029,6384,5249,39706
f,f,1814,535,114367,22651,1791,7373,21425,53240
u,f,1848,363,11853,841,87,311,170,1409
u,m,1834,1300,65720,3810,292,1266,792,6160
u,u,1815,123,5449,680,59,271,314,1324
u,f,1970,3797,56422,15830,1263,3523,3655,24271
f,f,1825,287,101243,13250,955,4120,10201,28526
f,f,1997,6957,705555,330780,21194,55389,186459,593822
m,f,1844,1302,194790,28761,2371,8589,20942,60663
f,u,1802,53,7833,1100,81,394,1224,2799
m,m,1842,2161,440927,63893,4281,18551,42846,129571
m,m,1914,14311,2139816,422806,31089,91643,211506,757044
u,m,1991,11315,198753,62941,4340,13486,13846,94613
u,u,1840,174,5420,498,53,150,87,788
f,u,1814,16,10178,1501,113,407,1326,3347
f,f,1959,2445,339399,126766,8384,20907,64114,220171
f,u,1915,589,95113,20434,1592,4961,12557,39544
u,u,1988,22377,360979,115551,7981,23418,24694,171644
f,u,1866,227,50826,7335,680,1919,5163,15097
u,m,1819,442,15021,862,73,281,309,1525
u,m,1815,232,2948,223,34,88,67,412
f,f,1813,410,69483,11315,803,4020,14119,30257
f,u,1879,513,115913,20130,1957,5346,15595,43028
m,m,1970,25816,1972801,773264,50309,130593,335076,1289242
f,u,1872,462,76318,13188,1293,3520,10046,28047
f,m,1821,221,24698,3442,302,1175,3176,8095
m,f,1849,1074,147230,24486,2038,6950,18911,52385
u,m,1865,1608,39120,4320,365,1385,1018,7088
m,u,1955,22242,1784188,631647,44151,116241,308516,1100555
u,u,1895,700,16179,2567,224,786,614,4191
f,f,2006,6444,730336,389139,24631,60855,214403,689028
f,u,1987,11078,737025,338232,26101,62786,183112,610231
f,f,1937,3041,433873,180597,12662,29514,92672,315445
m,u,1800,15,602,110,6,44,104,264
u,f,1960,2984,46694,14677,1147,3288,3171,22283
u,u,1821,74,398,81,8,46,24,159
m,u,1903,2530,333955,60651,4658,14532,34019,113860
u,f,1936,3393,59632,15327,1166,3592,3627,23712
m,u,1879,1205,199267,33934,3058,8785,20899,66676
m,m,1980,23721,2116822,750962,46662,125827,327603,1251054
m,m,1932,14479,1532209,489941,36222,94283,229627,850073
u,u,1968,26123,408638,128463,9144,28981,26121,192709
m,f,1860,2399,281092,49358,4508,13186,32960,100012
u,f,1840,518,18335,1699,156,533,411,2799
u,m,1872,3537,81019,7470,751,2421,1750,12392
m,m,2011,85,6866,2098,62,266,1015,3441
u,u,1880,275,4725,614,64,181,169,1028
u,f,1981,3894,82906,23298,1458,4350,5571,34677
f,m,1998,6688,477918,236864,15651,41666,132210,426391
u,u,1902,1487,47493,5755,451,1560,1170,8936
f,u,1969,13596,1131355,414067,33108,82127,236663,765965
f,u,1821,112,19897,5214,411,1681,5451,12757
m,f,1897,6220,896179,170167,14605,39015,99411,323198
f,f,1908,3213,707327,139396,10805,28229,85258,263688
f,u,1822,110,23404,3496,174,1402,4370,9442
m,f,1968,5376,454790,183535,13182,33319,81410,311446
f,f,2003,6348,665602,356123,23769,58565,197010,635467
m,f,1940,4583,480427,150826,10703,28837,65676,256042
u,f,1828,170,5477,545,37,199,115,896
u,u,1846,227,12569,707,56,266,94,1123
u,f,1941,2705,62561,14390,1030,2916,3026,21362
u,m,1806,86,2463,99,21,46,52,218
m,u,2012,0,0,0,0,0,0,0
u,f,1867,1458,37555,3805,376,1208,901,6290
u,u,1802,20,664,39,1,19,11,70
m,u,1892,1147,98539,18334,1514,4766,11164,35778
m,m,1954,19404,1797876,643402,42537,107425,276151,1069515
u,m,1826,950,33405,2382,159,777,726,4044
m,u,1816,196,14770,2674,233,910,2230,6047
m,m,1946,18848,1708839,584816,39812,101176,259235,985039
f,u,1845,165,22973,2561,214,739,2106,5620
m,f,1861,1227,105020,20409,2001,5471,13219,41100
f,u,1928,5375,607986,222437,17747,46585,135299,422068
u,u,1843,199,11347,1072,86,404,230,1792
m,u,1899,1438,159059,29397,2308,6890,17060,55655
f,f,1854,1148,261308,46837,4310,12400,36520,100067
u,f,1886,2311,75570,9206,872,2602,2270,14950
f,u,1876,322,68523,11456,1016,3060,8863,24395
u,f,1855,820,31031,2156,188,684,386,3414
f,u,1927,4938,422055,164810,13036,35613,98335,311794
f,u,1930,6640,730373,249226,19302,52092,143073,463693
f,f,1995,5880,641707,316320,20226,51364,165999,553909
u,m,1947,10871,196547,50409,3685,10881,10302,75277
u,m,1882,3448,78608,10500,1013,3212,2779,17504
f,f,1843,437,95540,12924,1108,4207,11931,30170
f,u,1978,9296,741257,327555,23370,60593,178625,590143
m,m,1937,16873,1580762,532301,38511,97764,246955,915531
f,u,1862,328,73930,11494,988,2704,8083,23269
m,f,1946,7690,837098,250788,17558,44569,109524,422439
f,f,1931,2728,389575,139079,11025,26854,80538,257496
f,u,1899,490,83415,14169,1096,3419,9920,28604
u,u,1853,226,7686,805,56,268,122,1251
f,u,1986,12290,910747,403979,28594,75070,221868,729511
m,u,1927,14634,867028,304366,24398,67708,166067,562539
m,f,1846,907,121250,20590,1844,5540,15091,43065
m,u,1914,1921,225734,37620,3195,9369,21751,71935
m,u,1945,16010,1217857,422989,30791,75106,196625,725511
m,m,1959,18923,1864322,624012,39841,104944,275156,1043953
f,f,1827,789,191456,29580,2237,9723,23956,65496
m,u,1844,264,27326,5861,398,1749,4364,12372
f,u,1891,452,71989,13686,1294,3538,10198,28716
m,u,1849,384,40861,7814,713,2053,5714,16294
f,u,1885,205,21041,3367,381,883,2606,7237
f,m,1946,5869,627422,220247,16015,39699,110545,386506
f,u,2005,11978,751477,393091,28027,71406,219776,712300
m,f,1918,6574,761796,179894,13401,37096,84966,315357
m,u,1960,23764,1881958,714165,47968,135846,355183,1253162
u,f,1901,2779,67823,10394,788,2716,2342,16240
f,m,1806,112,9816,1784,158,581,2129,4652
f,u,1953,7141,573594,210842,15260,39415,112093,377610
f,f,1952,3126,407606,152353,11278,27304,79328,270263
u,m,2013,16,0,181,23,63,41,308
u,m,1873,1560,57852,5499,489,1695,1196,8879
f,m,1826,489,93092,10641,800,3268,10460,25169
u,m,1850,1938,73241,5790,486,2058,1344,9678
m,m,2003,21415,1494073,652026,41641,109562,294424,1097653
f,m,1895,4479,734343,137297,11637,32853,87137,268924
u,f,1887,2880,106349,11665,1055,3552,2806,19078
f,u,1935,4933,530755,197219,15520,38109,118010,368858
m,f,1996,12840,939974,389796,26182,68933,171232,656143
f,m,2011,32,4590,1139,25,172,509,1845
m,m,1927,16046,1708881,507173,37729,104933,263459,913294
f,f,1940,2243,397443,134887,9376,22759,65030,232052
f,m,1868,1133,153679,27827,2607,8313,21256,60003
m,u,1864,971,117048,17175,1553,4220,10231,33179
u,u,2006,20214,363576,128671,8461,24548,29158,190838
m,m,1941,11925,1239280,392762,26181,69422,179739,668104
u,m,1975,10690,187493,53229,3283,10230,10531,77273
u,f,1806,123,7129,1126,64,365,363,1918
f,m,1901,3285,632776,108413,7987,24827,66848,208075
m,f,1820,654,71915,17838,1513,5397,12577,37325
f,m,1979,6444,626961,237970,16452,41515,123218,419155
m,f,1982,8803,774038,279362,20297,51047,128199,478905
u,m,1809,223,3387,425,36,156,81,698
u,u,1929,15208,283742,65002,4660,16205,13209,99076
u,f,1946,3421,69312,16403,1261,3599,3300,24563
f,u,1888,422,63170,10222,871,2385,7810,21288
m,f,2011,0,0,0,0,0,0,0
f,f,1947,3504,496938,177130,13084,29738,88979,308931
m,m,1860,3422,512007,71891,6207,21186,49966,149250
m,m,1850,3896,646396,81503,6539,24919,57677,170638
f,u,1949,5893,528074,207142,14898,37404,107801,367245
u,f,1983,3838,86766,24746,1516,4465,5785,36512
u,m,1901,5460,155675,20374,1520,6125,4033,32052
u,f,1902,2211,66110,10417,843,2638,2904,16802
u,f,1958,2827,56239,15974,1138,3290,3398,23800
m,m,1873,3019,440572,71127,5803,19194,44274,140398
f,m,2004,7802,510349,280593,18766,48276,148087,495722
f,u,1878,218,29420,6314,540,1560,4838,13252
u,u,1967,25734,401736,116912,8291,27821,24116,177140
m,f,1997,13169,889892,397235,27800,72783,192666,690484
u,u,1814,27,107,17,1,9,1,28
f,m,1855,1004,177987,25866,2231,7983,18902,54982
m,m,1922,20358,2387641,580615,42592,119881,288444,1031532
u,u,1959,15002,311292,76087,4983,16783,15471,113324
u,f,1968,2795,52418,15680,1045,3154,3390,23269
u,m,1973,11191,208411,53355,3554,10427,11410,78746
m,m,1877,4489,711421,100432,8707,26505,64443,200087
f,f,1803,123,22452,3282,232,1277,3730,8521
u,m,1808,308,9857,1328,115,497,484,2424
u,m,1801,300,9011,940,79,360,218,1597
m,u,2005,31180,1513615,725892,51390,139004,354628,1270914
f,u,1903,1059,181973,32781,2586,7372,21417,64156
f,m,1881,1895,408257,73839,7004,18123,49919,148885
f,u,1832,433,41732,6404,576,2080,7600,16660
m,u,1834,520,61846,7746,596,2217,6286,16845
f,m,1982,6683,683357,261898,17121,45438,126817,451274
m,m,1805,95,8796,1426,111,509,1212,3258
f,m,1832,412,95515,12496,1069,4146,10979,28690
f,f,1930,2692,343673,148257,11277,28525,85160,273219
f,f,1986,4422,593634,249407,17025,42148,136401,444981
u,m,1932,6910,144747,33841,2316,7619,7281,51057
u,f,2003,5859,108415,38529,2598,7089,8688,56904
m,u,2009,8845,302636,196454,14663,37381,96345,344843
u,f,1808,82,3157,348,21,143,34,546
f,f,1823,291,74471,13114,1180,4501,11177,29972
f,f,1941,3215,492962,152004,11176,27492,83302,273974
f,m,1981,6951,713965,282969,19329,48405,142048,492751
f,f,1821,309,101803,19079,1472,5123,17638,43312
m,f,1863,1846,303935,54281,4726,14304,33251,106562
f,f,1992,5555,612240,309537,19540,48636,159728,537441
u,m,1999,10593,204110,57226,3660,10801,12817,84504
f,f,1970,3267,360923,141100,10367,24772,66595,242834
m,u,1934,12190,804706,300845,22932,60465,153462,537704
m,f,1960,5905,593588,209490,14682,37206,88274,349652
u,m,1952,9232,201925,50423,3524,10322,10746,75015
m,u,1998,31218,1410685,688747,50440,133453,346906,1219546
u,m,1926,6760,214482,32757,2511,7406,6862,49536
m,f,1913,7368,1014316,205166,15740,44785,107061,372752
f,f,2000,6128,719397,370223,24606,59394,197452,651675
f,u,1939,3493,349964,118647,8511,22817,63943,213918
m,u,1847,270,39376,4830,405,1945,3981,11161
m,m,1994,19377,1328453,587882,37844,99321,264204,989251
m,u,1868,1070,153990,29222,2157,7515,16774,55668
u,m,1981,12806,287557,70971,4893,13312,14994,104170
m,u,1818,126,9905,1826,179,609,1880,4494
f,m,1915,4076,730829,160883,12610,34264,92279,300036
f,f,1875,2194,430754,87659,7884,21278,66907,183728
f,u,1810,69,4563,1026,83,348,1123,2580
f,u,1919,811,122905,28484,2522,6236,18185,55427
u,f,1937,2771,71496,18095,1389,3645,3904,27033
u,m,1942,6849,122637,34979,2281,7395,6724,51379
u,u,2003,17575,331052,101840,6855,20133,22066,150894
u,u,1836,68,4239,431,38,178,73,720
f,u,1932,4317,413882,162331,12800,32479,95045,302655
u,u,1825,199,4193,411,51,138,137,737
f,m,1837,621,102907,14016,1234,4446,12844,32540
f,m,1811,223,17788,5483,456,1945,5831,13715
m,u,1939,11395,973660,311287,21150,58530,152267,543234
m,f,1914,6163,804992,172867,12917,37784,90599,314167
m,f,1941,6081,694705,216981,15031,40237,101316,373565
f,m,1956,5588,617481,219068,14937,38706,111128,383839
m,u,1915,1565,187438,37885,2712,9079,19769,69445
f,f,1967,2545,240003,110193,8155,19259,57039,194646
f,f,1954,3301,481253,180689,12307,30886,94571,318453
u,u,1930,13066,326976,72884,5141,16402,15290,109717
m,m,1882,6839,752126,145692,13404,36545,89936,285577
f,f,1836,709,162753,23577,2083,7330,22424,55414
f,f,1877,1522,298180,59613,5708,15006,46028,126355
m,u,1920,2818,366751,79835,6280,16712,41642,144469
u,u,1990,26058,491993,142690,10213,29050,31762,213715
u,u,1841,83,1964,208,18,82,53,361
f,f,1987,5917,889231,353485,23740,58205,191879,627309
u,m,1898,8478,269949,35084,2741,10252,7702,55779
m,u,1857,992,118971,20205,1834,5343,14401,41783
u,u,1992,26336,511855,145387,10499,30266,32656,218808
m,m,1847,1737,262742,37656,2855,11270,25639,77420
m,f,1803,172,15090,3980,312,1379,3335,9006
f,f,1932,2245,330556,138440,10105,25018,77729,251292
f,m,1848,806,135904,18926,1487,5702,16551,42666
m,f,1994,11927,820598,385409,25288,68226,178701,657624
u,m,1938,6557,130553,32058,2367,6836,6597,47858
m,f,1813,562,86363,12784,1001,4065,12437,30287
u,u,1937,8547,169738,40307,3267,9108,7877,60559
u,f,1819,164,1145,599,74,241,122,1036
u,f,1997,6326,116685,34155,2155,6147,8623,51080
u,u,1957,13912,331986,80144,5648,17234,15949,118975
m,f,1959,4767,431319,151723,10920,27570,67775,257988
m,m,1853,4279,363179,48717,4036,14607,34932,102292
u,u,1931,11949,235365,55437,3713,12926,12283,84359
m,u,1935,13799,1164783,388782,29643,74733,198674,691832
u,u,1983,24328,440198,123768,8111,24707,26150,182736
u,u,1938,8563,128049,40841,2953,9007,7998,60799
m,f,1915,7271,994983,204319,15833,45800,105819,371771
u,f,1999,5695,76858,29989,2118,6212,7611,45930
m,f,1825,433,74095,11351,919,3236,7577,23083
f,f,1872,1791,375071,60631,5781,15347,45144,126903
u,m,1989,15096,312215,80481,4970,14748,16486,116685
u,u,1941,7401,127366,34551,2441,8398,8131,53521
f,f,1974,2652,346823,132935,9414,23755,71802,237906
m,u,1805,11,110,65,8,21,88,182
u,f,1829,337,11888,941,99,339,286,1665
f,u,1828,172,29670,4359,343,1143,2738,8583
u,f,1929,2566,56243,16131,1345,3292,3243,24011
m,m,1836,2343,282681,31170,2516,9321,25098,68105
u,u,1829,37,639,69,10,31,37,147
u,m,1802,14,714,38,6,15,3,62
u,f,1904,2592,97002,12467,861,2812,2622,18762
f,f,1881,2319,492093,93969,8361,22346,66354,191030
m,u,1995,32357,1579556,682962,49012,132994,341471,1206439
f,f,1955,2912,429941,160775,10545,26264,77298,274882
u,u,1872,343,7488,873,79,288,253,1493
f,u,1974,8424,555445,267540,21206,54544,155928,499218
u,u,1976,20593,319350,91591,6767,19825,19350,137533
m,m,1986,22256,1817861,696567,43834,116104,309337,1165842
m,f,1857,2000,289362,53251,5198,14332,35589,108370
u,u,1803,90,760,100,15,36,17,168
f,m,1985,6568,737463,260856,16493,44525,126696,448570
f,u,1916,815,149260,31172,2364,6786,19927,60249
u,m,1829,1910,89260,5197,451,1743,1208,8599
u,f,1956,2952,71519,20196,1510,3875,3775,29356
u,u,1987,20445,328332,107441,7420,22188,23724,160773
m,m,1926,12878,1242878,381375,28799,78383,202358,690915
f,f,1832,726,141228,20393,1995,6142,17502,46032
f,m,1957,5214,528878,193370,13106,35254,94021,335751
m,f,1919,6481,910855,203913,15881,43483,101333,364610
f,m,1808,151,13069,2998,290,1179,3765,8232
f,m,1994,6152,445086,207768,13584,35842,108682,365876
f,m,1813,68,3138,394,36,182,422,1034
m,f,1831,669,81215,10965,958,3300,8344,23567
m,u,1863,530,79541,12179,1110,3017,7774,24080
u,m,1860,1554,58307,4945,351,1585,1056,7937
u,m,1833,1090,45818,3467,277,1012,757,5513
u,f,1917,3139,102131,16003,1109,3640,3354,24106
f,f,1942,2501,479243,148884,11061,26227,77809,263981
u,m,1931,6290,146130,31331,2301,7519,6758,47909
u,f,1906,2933,94377,13386,995,3111,3067,20559
f,u,1966,9227,784205,312414,23261,59143,173504,568322
m,u,1829,125,24355,4193,397,1288,2785,8663
u,f,2001,5513,113130,31767,2181,6522,7918,48388
f,m,1924,4822,614601,207229,15537,40548,117239,380553
m,m,1852,4445,667757,89397,7715,25631,63040,185783
m,u,1837,167,20730,2506,182,793,1900,5381
f,m,1939,3599,413628,130625,9773,24527,67870,232795
f,u,1856,345,80266,8901,779,2565,7596,19841
f,f,1810,338,58023,13213,1021,4859,13872,32965
u,u,1878,284,9990,914,91,235,229,1469
f,u,1892,451,53868,12718,1091,3269,10239,27317
f,u,1955,6840,788830,264281,19069,49695,144749,477794
f,f,1842,563,129621,21311,1927,6192,18681,48111
f,f,2005,6457,697830,345389,22884,57594,190516,616383
m,f,1824,749,163675,23987,1964,7334,17090,50375
m,m,2013,21,2072,1008,132,354,448,1942
m,u,1859,543,38893,9331,821,2387,5862,18401
m,u,1918,1539,152651,33771,2297,7534,16415,60017
f,f,1858,966,290064,46213,3952,12236,35726,98127
f,m,1990,8854,904227,325606,20877,56879,167338,570700
u,u,1858,793,19996,2063,178,637,606,3484
f,f,1929,2625,373030,133072,10411,24812,77732,246027
m,m,1870,3804,625164,95628,7689,26529,60311,190157
f,f,1919,4063,866319,180019,13989,36057,108193,338258
f,m,1919,4281,765663,171470,13496,36245,98509,319720
m,u,1872,914,89420,20830,1991,5267,13708,41796
f,u,1815,219,29581,5144,493,1525,4194,11356
f,m,1918,3853,539801,127967,9942,26595,72699,237203
m,u,1963,24584,1610460,650753,46854,127243,325477,1150327
u,m,1985,12108,288762,74948,4252,12972,15492,107664
m,m,1965,22089,1796299,672427,43395,114299,308259,1138380
f,u,2011,4,0,0,0,0,1,1
f,m,1856,1468,218859,32630,2919,9873,24966,70388
m,f,1957,5437,512177,193636,14413,35216,80422,323687
f,f,1890,2700,528518,104115,9580,24910,72982,211587
m,u,2004,29223,1342640,643919,46732,123311,316581,1130543
f,u,1982,11393,882774,365114,27941,69113,193239,655407
m,m,1949,17266,1744728,556324,37449,98561,247742,940076
m,u,1896,1130,133843,23346,1884,5672,12258,43160
u,u,1954,11783,312432,81351,4959,16063,15461,117834
f,m,2009,4436,228618,165435,10869,28502,83808,288614
f,u,1979,11147,910556,360792,27656,68972,202036,659456
u,m,1951,9257,234038,53623,3556,10556,9402,77137
m,f,1878,3031,444157,75177,7038,17601,44538,144354
u,f,1986,4613,122088,32473,1927,5467,7699,47566
m,m,1896,17945,1837741,345221,27380,84206,198771,655578
u,u,1986,20600,387835,112782,7669,22610,23322,166383
u,u,1824,42,443,51,3,21,18,93
m,f,1890,5272,645386,126263,11583,31404,75031,244281
m,m,1845,2331,351800,45207,3592,13528,32425,94752
f,f,1806,132,20363,5352,437,1901,5549,13239
u,m,1862,1522,42228,5053,447,1398,790,7688
u,f,1938,2928,57584,15388,1094,3425,3285,23192
u,f,1885,1605,43795,6459,631,1851,1683,10624
m,m,1942,13850,1297372,467296,31248,85469,211703,795716
u,u,1891,600,14504,2388,221,647,601,3857
m,m,1985,22189,1993431,737006,46052,124134,317868,1225060
f,f,1938,3407,611274,220305,15423,37701,127211,400640
u,u,1984,19862,389174,101380,6568,23440,20166,151554
f,f,1895,2935,625349,121754,10258,26095,81136,239243
f,u,1816,129,15685,2150,254,781,2071,5256
u,f,1953,2673,50219,13848,1022,3044,3095,21009
f,u,1897,287,34820,7656,706,1755,5396,15513
m,u,1928,15333,1076970,417053,30979,88936,230160,767128
u,u,1919,1352,24857,4736,419,1181,1082,7418
u,m,1885,4334,124194,14343,1149,4122,2946,22560
u,f,1923,1288,24655,6136,540,1543,1295,9514
u,f,1900,2799,76225,10479,917,2762,2490,16648
f,f,1891,2857,677099,120986,10583,27181,83385,242135
u,f,1875,1479,31806,5672,550,1576,1596,9394
m,u,1809,51,2053,843,83,296,672,1894
u,f,1869,1108,39084,4124,387,1268,1002,6781
u,m,2010,83,257,360,29,41,47,477
f,f,1878,1576,350516,69070,6337,15911,50835,142153
m,f,1871,2369,354749,62768,5558,15846,38004,122176
f,f,1804,129,7032,3311,341,957,2417,7026
f,u,1812,78,8021,2705,239,813,2326,6083
m,f,1925,3035,229490,91832,7532,19358,44949,163671
u,f,1876,1281,51878,5858,586,1556,1736,9736
m,u,1924,11889,790571,272456,21408,57391,145623,496878
u,m,1835,990,38203,3068,301,1006,701,5076
u,m,1910,6363,152404,22794,1744,6252,5385,36175
u,m,1867,1375,37858,4383,413,1316,926,7038
u,u,1800,13,76,22,1,6,2,31
u,f,1984,4219,117932,29706,1858,5439,7471,44474
m,u,1949,17646,1215801,469928,33306,91378,227249,821861
m,m,1971,21840,1617749,629297,40903,107029,283102,1060331
f,m,1871,1122,167303,35502,3084,9985,27005,75576
u,m,1866,2309,81804,7597,710,2393,1477,12177
m,u,1910,1884,224660,44811,3251,9782,24173,82017
u,u,1917,1314,54194,6744,516,1646,1283,10189
m,u,1902,2600,235166,45549,3724,11120,25920,86313
f,u,1975,10687,824603,347235,27278,71356,200209,646078
u,f,1940,2080,57930,11716,832,2587,2437,17572
m,m,1858,2724,399946,55316,4556,16170,36661,112703
u,f,1976,3142,77761,22427,1465,4208,4790,32890
m,u,1884,515,56225,10870,1148,2954,5791,20763
u,u,1940,7724,174973,47090,3223,10453,8876,69642
u,f,1843,508,18598,1661,133,580,360,2734
m,u,1991,38483,1732117,835834,60981,159361,412501,1468677
m,f,1812,451,81035,13453,1122,4479,10221,29275
m,u,1802,57,8322,1282,102,438,1100,2922
f,f,1829,577,126956,19111,1645,5767,18105,44628
u,u,1956,13879,327423,78226,5302,16731,15947,116206
f,f,1867,1733,392927,71222,6933,17243,52571,147969
u,u,1842,117,1385,197,30,45,50,322
f,u,1823,91,21768,3566,301,996,2987,7850
f,m,1896,5408,687361,131160,11369,32406,86278,261213
u,m,1949,8199,158591,37696,2494,7617,7786,55593
f,u,1901,943,195934,33699,2801,7696,22795,66991
m,f,1992,10380,663113,318860,22399,56959,145227,543445
m,f,1978,6435,582591,218706,16036,40044,105428,380214
m,u,1964,24706,1747848,660010,46713,127310,327387,1161420
u,u,1974,15288,275256,75321,5370,15950,15035,111676
u,u,1804,30,173,96,6,38,17,157
f,f,1853,1145,303522,42494,3723,11294,33943,91454
m,f,1909,6258,788841,157482,12555,35292,80242,285571
m,f,1853,1573,248949,37555,3596,9925,25646,76722
m,f,2012,0,0,0,0,0,0,0
m,f,2014,0,0,0,0,0,0,0
m,f,1896,7359,935361,158078,13619,38313,92196,302206
m,f,1900,5448,636377,125390,9884,28033,69389,232696
m,f,2005,12007,802179,389503,27328,70220,183513,670564
u,m,1905,4679,136092,18304,1287,4828,3547,27966
m,u,1912,1837,201122,38992,2880,8424,20211,70507
u,u,1852,197,4564,584,41,164,64,853
m,f,1891,4970,690150,125793,11345,30205,72408,239751
u,m,1822,248,7991,512,45,170,114,841
f,u,2009,3257,169268,115225,8165,21503,64238,209131
u,f,1992,5348,122556,38171,2329,7171,9823,57494
m,m,1987,24632,2215894,852228,53300,140500,369621,1415649
f,m,1866,1498,270733,40623,3744,11590,31508,87465
f,u,1806,18,116,264,30,115,374,783
m,m,1881,5826,873221,143386,12609,35761,83067,274823
m,m,1975,19114,1681665,645648,40349,109762,290931,1086690
u,m,1837,1139,49394,3694,303,1323,758,6078
f,m,1891,3108,530635,98805,8478,23295,66163,196741
f,m,1912,5217,928326,183321,14609,40208,106412,344550
u,f,1889,2535,95115,10669,952,3110,2608,17339
f,f,1855,1218,336820,52524,4356,13737,44883,115500
m,m,1863,2489,325438,50850,4490,14213,33550,103103
m,m,1812,439,54309,8040,526,2703,5874,17143
f,m,1822,239,19170,4443,394,1369,4130,10336
f,m,1876,1482,292431,50975,4362,13532,40115,108984
u,u,1942,7699,124724,35080,2582,7615,7181,52458
u,f,1851,582,13113,1361,132,536,481,2510
f,f,1978,3269,427742,182198,12986,30028,97105,322317
m,u,1948,21700,1536569,585040,43284,115189,283569,1027082
f,f,2001,6295,672050,331715,21520,53546,176367,583148
f,u,1983,12937,912027,392605,29228,73244,209255,704332
m,m,1826,1942,345521,38874,2767,11286,31942,84869
u,f,2006,5730,108928,41539,2725,7452,9019,60735
m,u,1907,1188,115042,25535,2053,5996,14241,47825
f,m,1978,7313,707714,282273,18823,49137,137945,488178
m,u,1950,21911,2098398,703362,49887,143538,357795,1254582
u,u,1823,30,355,123,8,28,17,176
u,u,1810,111,711,155,17,72,54,298
f,m,2002,6352,503865,238507,15141,40421,128207,422276
f,m,1922,6517,1046576,246391,19395,51256,142321,459363
f,m,1932,4731,503236,189013,15061,37405,101929,343408
u,m,1899,12320,394884,49170,4092,13500,12209,78971
m,f,1817,597,104724,19015,1319,5283,16082,41699
u,f,1858,844,23419,3312,308,932,672,5224
u,m,1986,11926,244661,63748,3990,11799,12741,92278
f,m,1892,3701,572178,113891,9817,28330,77122,229160
f,u,1825,158,16148,3466,397,970,3065,7898
u,m,1823,1000,24759,2298,204,843,511,3856
u,f,1993,5021,111403,35841,2434,6090,8663,53028
f,f,1834,726,202689,27847,2306,7993,23757,61903
m,m,1856,3706,461204,68765,5607,19407,44068,137847
f,u,1994,15349,1023098,494799,36248,90568,277203,898818
f,f,1870,1414,363047,65478,5804,15930,47835,135047
u,u,1971,18059,387325,95800,6342,20751,20605,143498
f,u,1998,12433,814380,386369,27720,70124,218291,702504
m,u,1854,855,112405,15636,1357,3873,9274,30140
f,f,1968,2697,315886,137444,9442,23625,70195,240706
f,f,1830,417,83010,13519,1131,3969,14066,32685
m,m,1978,24501,2178188,817241,51655,133915,354103,1356914
m,m,1966,21534,1823612,712526,45650,119025,306966,1184167
u,u,1972,17319,266485,75938,5626,16481,16354,114399
f,m,1942,3715,370098,136880,10095,26634,69804,243413
f,m,1974,6267,426779,182142,13114,33781,93153,322190
u,f,1972,2439,53667,12615,895,2566,2562,18638
m,u,2011,31,1795,34,8,23,0,65
m,m,1824,1482,131257,22825,1820,7199,18506,50350
u,f,1877,1417,54105,6935,560,1866,1929,11290
f,f,1966,2673,301022,118403,8661,20198,56155,203417
m,u,1933,13834,1170897,385093,28696,79235,193369,686393
f,f,1996,7102,792329,367515,23397,59068,193458,643438
m,u,1893,1170,113422,24918,2008,5971,14923,47820
u,f,1987,5737,171109,40611,2424,7384,9486,59905
m,m,1982,22956,2277030,793416,49207,131435,349385,1323443
f,m,1853,1511,128793,18345,1709,5689,14584,40327
u,m,1936,6511,102106,27581,2101,6534,6480,42696
m,m,1905,10619,1453023,276739,20318,63422,148880,509359
f,f,2007,6584,641696,369014,24336,60318,205692,659360
u,f,1881,1809,51759,6876,608,1984,1628,11096
f,m,1966,6829,579676,227803,16225,41605,118745,404378
f,m,1845,751,121622,17880,1460,5371,15215,39926
u,f,1967,2616,43513,13399,962,2783,2579,19723
f,m,1877,1432,268226,40517,3785,10914,29707,84923
f,m,1809,97,1008,1233,91,476,1160,2960
m,f,1916,6165,822458,178353,14059,38558,89135,320105
m,f,1807,268,38999,11850,699,4200,10392,27141
u,f,1974,3380,67867,20795,1464,3914,5126,31299
u,m,1965,12412,248209,67428,4196,13265,12604,97493
f,f,1957,2858,390565,147265,10812,26543,73395,258015
m,u,1846,396,31001,3342,302,1132,2626,7402
u,m,1864,1673,47538,4289,476,1504,1256,7525
m,f,1971,4717,392131,154556,11168,26320,69934,261978
f,f,1999,6580,760009,367372,24132,59795,197980,649279
m,f,1838,1190,158806,20932,1970,6928,17402,47232
u,f,1954,3117,64953,17575,1289,3740,3792,26396
f,f,1985,5144,711388,305548,20483,50907,164781,541719
m,u,1840,309,26614,4279,349,1384,3825,9837
m,u,2007,33229,1788212,849907,57287,153770,408294,1469258
f,u,1811,72,12413,2273,166,721,2542,5702
f,u,1964,8051,710165,281216,20824,53784,154193,510017
m,f,1972,4399,324382,135511,9826,24709,61115,231161
f,u,1848,185,18323,3227,353,1113,3118,7811
m,m,1933,14476,1550139,466125,32895,87449,223053,809522
m,u,1897,813,89555,15702,1241,3618,9631,30192
m,m,1876,4540,723542,114080,9710,30205,72789,226784
f,u,1829,87,14410,2625,270,796,1941,5632
m,u,1817,136,8562,1882,194,706,1692,4474
u,u,1881,372,5713,919,100,284,229,1532
u,u,1975,19816,386876,99285,7179,21268,19626,147358
u,m,1980,12594,275761,71701,4512,13554,15577,105344
m,u,2002,28904,1462641,622129,44481,116038,303668,1086316
u,f,2000,5552,87835,33051,2268,6367,7919,49605
f,f,1924,1591,241944,78612,6312,15212,48986,149122
f,f,1828,282,66833,10507,862,3448,9627,24444
m,f,1995,10818,708733,338172,23414,61036,154470,577092
f,m,1858,860,151113,22525,1993,7204,17495,49217
f,u,1801,11,583,170,24,55,186,435
m,u,1833,164,17625,3102,245,916,2169,6432
f,u,1921,858,168889,35008,2781,7447,20160,65396
u,m,1903,5095,136667,18922,1464,5267,3997,29650
m,m,1916,13772,2025244,433143,30258,94112,217083,774596
m,u,1861,457,45330,7130,644,2138,5336,15248
f,m,1810,236,7992,6343,711,2261,5775,15090
u,f,1930,2267,42390,14198,1137,3280,3226,21841
u,u,2001,18737,315167,104217,7124,21253,23721,156315
u,m,1966,12570,226380,68749,4186,12868,13837,99640
f,m,2006,6625,404638,237481,15908,40417,127030,420836
u,u,1978,19418,405050,105859,7131,22300,23305,158595
f,f,1824,433,133540,20672,1738,6460,17848,46718
m,u,1947,21446,1849274,648577,47412,118733,309939,1124661
u,m,1877,2337,87543,8123,652,2479,1950,13204
u,u,1901,1496,32975,5155,451,1529,1247,8382
f,f,1990,6792,805576,347395,23557,58814,182110,611876
u,f,1822,228,5700,833,77,301,272,1483
u,m,1825,1389,46954,3846,321,1333,921,6421
m,m,1972,18647,1392373,552086,35778,94496,244832,927192
m,f,1808,96,11323,1301,130,486,1420,3337
u,m,1894,7243,198580,23561,1857,6858,4468,36744
m,m,2010,211,4497,3878,277,641,1745,6541
f,u,2007,13113,840140,438380,28992,74972,238571,780915
m,f,2006,11560,812415,420458,29383,75152,195684,720677
u,f,1853,507,20832,1639,172,558,340,2709
u,u,1918,863,17677,3227,235,830,548,4840
f,m,1847,589,124189,19169,1517,5905,15419,42010
f,f,1983,3397,437121,209682,14786,35054,105696,365218
u,u,1834,289,9064,835,51,250,156,1292
f,m,1815,183,43800,3741,333,1027,3128,8229
u,f,2010,12,0,67,3,12,6,88
m,m,1999,19712,1395596,612379,37436,104872,280867,1035554
f,u,1981,11229,844013,355446,27138,67243,192455,642282
m,m,1909,13025,1887341,341909,24670,78653,179242,624474
f,f,1971,2241,208143,94307,6987,16124,49212,166630
u,f,1823,276,9522,1035,86,312,190,1623
m,u,1856,609,88144,9828,887,2843,7150,20708
u,m,1858,1577,63413,6611,450,2109,755,9925
u,m,1979,12475,245117,65928,4183,12380,14839,97330
m,f,1815,867,196649,22594,1680,6626,16425,47325
f,u,1917,714,120821,24222,2179,5730,17129,49260
m,u,1908,1858,208541,41763,3130,9341,22064,76298
f,u,1873,292,56155,9973,985,2620,7037,20615
u,m,1996,10610,164399,51091,3259,9924,11947,76221
u,f,1947,2675,44626,12605,979,2761,2737,19082
m,m,1879,2463,317753,60575,5577,15522,37526,119200
f,u,2002,10425,752189,324648,22821,60145,188534,596148
f,f,1973,3035,288464,148944,10927,26669,74532,261072
u,f,1896,4210,167408,20322,1536,5614,4292,31764
m,u,1978,28644,1839788,710652,49232,133526,352710,1246120
f,m,1958,5486,557340,209260,15094,39124,102700,366178
f,m,1925,4201,578154,186759,14849,38172,111813,351593
u,m,1851,1093,44860,3836,309,1459,520,6124
f,f,1934,3173,421937,157625,12402,28685,88816,287528
m,m,1808,335,48266,6914,601,2292,7273,17080
u,m,1920,7104,183430,29797,2234,7521,6284,45836
u,f,1835,977,18619,1928,194,626,539,3287
f,m,1843,470,67277,8596,706,2872,7582,19756
m,u,2000,32152,1453531,677412,49054,132098,337076,1195640
u,m,1909,5580,140729,20400,1600,5454,4724,32178
m,u,1982,31256,1822515,724356,53218,139181,351112,1267867
m,m,1955,19962,1922231,708347,47054,119988,307861,1183250
m,f,1805,75,9695,2420,161,759,2077,5417
m,f,2007,12366,754506,413520,28625,74446,193688,710279
f,f,1818,442,76395,14142,1376,4675,12883,33076
f,f,1984,4235,563423,236055,15659,38207,121436,411357
m,f,1843,897,125070,18763,1446,5659,15325,41193
f,u,1948,7393,679300,264350,21400,52800,147488,486038
m,u,1996,35186,1778526,742602,55413,148114,365114,1311243
m,m,1950,19279,2277305,700658,44824,118826,318687,1182995
u,f,1878,1526,44368,5360,529,1590,1543,9022
m,m,1981,23232,2095772,771584,48800,127106,333737,1281227
m,f,1920,7497,898534,201035,16344,43969,101848,363196
m,f,1804,179,8470,3836,400,1074,2710,8020
m,u,1970,39184,2206783,848466,65177,176148,441948,1531739
f,m,1805,30,590,296,42,119,289,746
m,f,1893,6463,838929,164773,14634,39364,92001,310772
f,m,1835,571,110173,13921,1127,4428,12805,32281
u,f,1895,2711,70552,8948,869,2598,2155,14570
f,f,1975,3209,349361,144188,10805,25853,73911,254757
u,u,1925,9292,215947,43933,3285,11503,8869,67590
f,u,1910,574,90935,17613,1275,3803,11289,33980
m,u,1962,28182,2160892,761835,53371,150067,377487,1342760
f,u,1871,259,43392,7190,736,1743,4802,14471
f,m,1900,3230,442746,87613,7025,21198,56451,172287
m,u,1807,99,8514,2105,205,700,1736,4746
m,m,1807,160,9938,2537,186,853,2195,5771
u,f,1839,496,14660,1716,127,621,452,2916
m,u,1994,37034,1913545,863123,63581,164873,417931,1509508
u,m,1820,348,13187,1416,109,377,277,2179
u,f,1933,2033,44988,10997,818,2316,2511,16642
m,m,1993,19426,1231600,586012,37977,100457,264550,988996
m,f,1875,3215,424526,91864,7955,22988,55178,177985
f,u,1839,251,47325,5893,501,1869,5334,13597
f,m,2005,6972,508835,254761,16596,44513,135008,450878
m,f,1884,4265,554155,107254,9922,24988,61851,204015
f,u,1860,455,78043,12835,1099,3642,10718,28294
u,u,1855,349,5859,884,93,299,253,1529
f,f,1935,3179,422704,160401,12130,29962,88358,290851
f,u,1854,362,78115,12317,1024,3224,9126,25691
m,m,1934,15060,1684740,528559,38474,102182,258243,927458
u,u,1860,495,36018,2661,240,866,526,4293
u,f,1920,3305,66378,12140,1052,3208,3069,19469
u,f,2007,5989,64306,29736,2241,6078,6762,44817
u,f,1925,1537,28074,8399,672,1860,2021,12952
m,u,1882,2068,173681,28374,2446,7451,18881,57152
m,u,1814,40,7755,994,92,298,679,2063
f,u,1896,398,79135,14771,1281,3367,8390,27809
f,f,1923,1354,172368,64563,5280,12687,36810,119340
m,u,1860,1071,150923,23339,2057,6267,16576,48239
u,m,1955,10591,207825,59293,4029,11435,10883,85640
m,f,1927,3504,377080,117921,9789,24845,59657,212212
m,f,1930,4597,377263,142989,11047,29780,67714,251530
f,m,1913,5288,952617,191748,14775,41781,114730,363034
u,m,1895,7220,179957,24602,2039,7241,5513,39395
m,f,1856,2306,363895,54660,5151,14338,37665,111814
u,f,1919,2924,97563,12940,1094,3550,3399,20983
m,m,1901,10766,1443218,260282,19262,62230,145295,487069
m,f,1818,610,69041,13633,1303,4307,10668,29911
m,u,1888,1130,125582,19632,1602,4936,12115,38285
f,m,1995,6472,610516,261131,16520,44401,138844,460896
f,f,1885,2164,475471,93188,8288,22624,66577,190677
u,f,1894,2457,75335,8721,759,2523,2483,14486
f,m,1927,5257,622458,208588,15937,43952,123990,392467
f,u,1820,47,12482,1651,146,530,1023,3350
u,f,1857,736,17206,2166,221,726,513,3626
f,m,1898,4826,834620,147406,11916,36641,96715,292678
u,m,1841,1081,39828,3083,220,1205,662,5170
f,m,1879,898,174898,34359,2951,8689,23245,69244
u,m,1859,2631,102486,7780,648,2271,1550,12249
u,m,1880,3235,98493,10419,886,3079,2681,17065
u,u,1828,139,4489,257,22,81,63,423
u,u,1820,52,1103,109,13,32,28,182
f,u,1904,783,141703,26127,2090,5781,17740,51738
f,u,1887,267,46164,7317,658,1791,5554,15320
f,f,1912,4144,892659,163218,12530,34464,101714,311926
f,f,1879,1317,321592,63368,6190,14133,44170,127861
u,f,1939,1962,40991,11620,846,2340,2235,17041
u,f,1803,86,2543,418,40,158,110,726
m,m,1859,5095,698524,89332,7692,24694,64385,186103
m,f,1814,863,80549,19426,1582,5777,16775,43560
u,u,1889,476,12032,1540,142,408,437,2527
u,f,1971,2305,34771,10789,782,2189,2595,16355
u,m,1945,6833,129396,33452,2315,6928,5681,48376
f,m,1920,5068,839883,200110,16263,41817,113189,371379
f,f,1981,4440,641692,264920,17343,43736,139617,465616
m,u,1828,349,32670,4594,474,1367,3004,9439
f,f,1917,4017,875423,178032,13652,36693,101979,330356
f,m,1817,131,15917,2697,234,854,2115,5900
u,u,1818,54,311,79,7,30,18,134
f,m,1930,5463,600786,193379,15721,40267,110233,359600
f,u,1874,173,29973,4754,411,1344,3960,10469
f,m,1955,6287,749857,238340,17272,42767,118277,416656
u,f,1813,239,17568,1558,99,631,507,2795
u,f,1994,5968,147230,47547,2700,8026,11338,69611
u,u,1981,21288,368393,105580,7159,21353,24223,158315
m,u,2013,0,0,0,0,0,0,0
f,f,1956,2898,469007,163653,12171,27927,82893,286644
f,f,1918,3912,804123,173406,13113,35825,99549,321893
m,f,1951,6164,574106,199059,14654,36121,90814,340648
f,m,1850,1481,410464,53699,4105,16421,45710,119935
f,f,1969,3000,355484,152669,11102,25883,73553,263207
u,u,1999,20455,346713,112198,7605,22863,27108,169774
m,u,1862,533,78166,13178,1381,3483,8174,26216
u,f,1831,279,18765,959,90,379,264,1692
m,f,1879,2117,287902,59879,5535,14040,34281,113735
f,u,1972,9475,796359,308164,23526,61273,177196,570159
f,f,1826,313,74829,10542,879,3323,10310,25054
f,u,1907,467,69168,15299,1372,3716,9295,29682
f,m,1859,1604,235373,32198,2924,9304,27320,71746
u,m,1988,14664,353680,84684,5073,15356,18789,123902
f,m,1804,192,15955,3356,289,1093,2979,7717
f,m,1829,1055,190818,19902,1546,5811,19876,47135
u,m,1853,2134,48751,5959,485,2012,1548,10004
f,m,1969,8286,632001,263446,18877,47457,135863,465643
u,m,1863,1238,38483,3522,344,1311,805,5982
m,m,1977,20187,1661253,650327,40752,105980,290924,1087983
f,m,2008,5437,334286,216209,14333,38019,115047,383608
f,m,1814,8,0,37,3,7,47,94
f,u,1942,3795,388078,141661,10513,26537,74989,253700
u,u,1949,12595,219834,58579,4077,12600,10796,86052
f,m,1989,8590,804530,332883,22536,58761,172447,586627
m,u,1843,376,72475,7955,556,2319,5778,16608
u,u,1973,17604,292284,86409,6192,18266,18157,129024
m,f,1907,5343,575693,122548,9513,26841,66930,225832
m,m,1894,13410,1790180,314289,24019,76564,174944,589816
m,f,1993,9509,584628,276760,19071,50973,131376,478180
f,f,1815,315,95989,13410,1093,4171,11865,30539
f,f,1914,3598,819325,150666,11106,31867,93529,287168
m,u,1880,770,98604,16119,1497,4434,9930,31980
f,f,1972,2152,248061,93324,6579,16529,49447,165879
u,m,1812,1240,29983,6137,484,2152,1074,9847
u,u,1934,8437,228094,38397,2923,9977,8242,59539
f,m,1870,1251,234939,39203,3402,10697,28614,81916
m,f,1954,6770,588037,222188,15945,41996,104621,384750
u,f,1966,2599,49439,15772,1126,3206,3468,23572
m,m,1963,19223,1380480,564324,38298,96973,247524,947119
f,m,1884,2603,409248,88101,8072,21670,60074,177917
u,f,1825,147,2856,381,38,147,84,650
u,u,1832,507,14230,1205,103,389,396,2093
f,f,1943,2867,471587,154932,10729,25798,73666,265125
f,u,1922,2396,211785,79578,6004,18187,47920,151689
f,m,1987,7670,718448,276705,18568,48164,140603,484040
m,m,1866,5147,903077,149886,11766,36926,90158,288736
u,u,1879,703,21023,1811,181,556,327,2875
u,u,1833,84,5202,247,24,122,91,484
u,u,1848,169,9762,542,44,250,116,952
f,u,1992,15464,975792,497672,36275,90795,279581,904323
f,f,1809,295,57536,9582,919,3274,8879,22654
m,f,2003,12008,786602,387470,28338,71044,178489,665341
f,f,1961,2465,354567,131562,9076,21667,65886,228191
f,u,1914,698,121787,22633,1749,5141,14400,43923
u,m,1884,4095,90640,11730,1105,3855,2760,19450
f,m,1964,6055,549443,223676,16369,41065,111485,392595
f,u,2000,12701,857516,371359,26176,70018,213419,680972
f,m,1962,6209,598665,205943,14756,37646,100872,359217
u,m,1929,9328,162283,38387,2804,9573,7603,58367
u,f,1911,2933,86712,14170,1133,3524,3538,22365
m,m,1925,13243,1464586,426531,32363,84361,226185,769440
u,f,1913,3133,99284,14579,1142,3688,3758,23167
m,u,1940,11349,950097,329807,22818,60540,155087,568252
f,f,1962,2538,356125,127580,9197,21277,61934,219988
f,u,1991,14487,969499,458235,33881,87402,256623,836141
f,u,2001,10404,757636,338999,22792,59594,197620,619005
f,u,1951,7004,717712,284638,21689,54466,158102,518895
u,m,2009,7059,105344,42362,2613,7660,8453,61088
f,f,1851,771,211170,33000,3026,9485,30162,75673
u,m,1964,11081,204794,58467,4047,11645,11314,85473
f,m,1961,6875,618284,244345,17785,45669,121412,429211
f,u,1855,602,126096,20903,1856,6059,17173,45991
u,m,1934,8225,231855,45186,3158,10201,9804,68349
u,f,2014,0,0,0,0,0,0,0
m,u,1952,19173,1662425,572237,43006,115092,286983,1017318
u,m,1967,11519,197190,59388,3762,11892,12240,87282
u,f,1841,766,26869,1979,194,748,518,3439
u,f,1922,3777,101446,18749,1562,4183,4277,28771
m,m,1936,14106,1422083,453540,32023,84512,219369,789444
m,u,1926,16564,1046157,351978,27521,80316,195961,655776
m,f,1958,5342,508516,168784,12363,30159,73152,284458
m,m,1825,2726,373251,45717,3560,13824,37298,100399
m,f,1950,6427,590491,218185,16247,40604,97828,372864
u,u,1830,705,33920,2301,195,889,538,3923
u,f,1978,3639,95074,27222,1609,4789,6608,40228
m,u,1822,498,48657,5170,318,2030,4598,12116
u,m,1987,13077,243073,73884,4567,13673,15553,107677
m,f,1826,612,79425,12186,969,3702,10300,27157
u,u,1851,205,7022,498,33,163,120,814
m,m,1818,630,57287,6465,575,2099,4771,13910
u,m,1940,6517,147642,35771,2419,7302,7279,52771
u,u,1835,121,3315,263,29,102,100,494
m,f,1823,576,80948,15378,1372,5051,12039,33840
f,u,1952,6831,748755,257587,20519,51687,147959,477752
m,m,1940,13922,1624330,513016,33469,88283,223405,858173
m,u,1969,38070,2429989,871687,65748,173716,448558,1559709
m,f,1887,5278,663534,134082,12296,32798,78970,258146
u,f,1982,4570,150553,40548,2747,7309,9442,60046
m,f,1962,5422,528399,189703,13192,33686,82595,319176
f,m,1888,2915,567775,99846,8242,25075,71653,204816
u,u,1989,24010,423329,133544,9372,28046,28782,199744
m,f,1847,1238,152471,21372,1753,6626,16295,46046
m,m,1945,13905,1260088,438616,29950,72638,186139,727343
u,f,1963,2772,49800,15301,1051,3067,3793,23212
u,m,1821,357,16643,1206,78,374,240,1898
u,u,1924,8256,150374,35285,2591,8867,7088,53831
f,u,1875,134,23137,4914,497,1182,3587,10180
u,u,1920,1518,42487,6452,524,1647,1527,10150
f,u,1947,7536,864133,298006,22596,53625,160075,534302
u,u,1910,1099,26721,4166,320,971,987,6444
u,u,1893,468,7527,1279,140,396,329,2144
m,m,1862,2167,253104,42605,3664,11275,29534,87078
m,f,1961,5078,436954,170970,12771,30454,78143,292338
u,m,1857,2308,92271,8212,683,2854,1608,13357
u,f,1912,3296,80525,12812,1051,3425,2986,20274
m,u,1865,888,102809,19507,1766,4971,11595,37839
m,u,2006,29729,1482410,738784,49845,131706,359042,1279377
f,f,1925,1835,243680,97147,7630,19419,57322,181518
m,u,1986,32787,1831352,742006,54075,142635,358144,1296860
f,m,1934,4971,575558,195406,16124,39443,108621,359594
f,u,1826,56,7596,1402,81,540,1330,3353
m,u,1823,81,7314,1336,153,396,1146,3031
f,m,1908,3873,602028,133972,10559,30866,83208,258605
u,u,2005,20800,345417,118153,8180,23599,26962,176894
u,f,1826,351,18769,1509,126,462,522,2619
m,u,1836,187,14629,2502,262,783,2475,6022
u,u,1839,184,5544,474,40,214,100,828
u,u,1962,19767,410339,108139,6987,24476,20612,160214
f,u,1818,97,11603,2544,295,883,2926,6648
u,m,1984,14029,257936,95468,5219,16953,21494,139134
f,f,1833,722,159141,24457,2112,7429,21706,55704
f,m,1940,3978,443998,161529,11595,30400,80030,283554
u,m,1827,557,19579,1799,247,588,433,3067
m,u,1813,25,3094,836,101,250,588,1775
m,m,1964,20451,1871865,684496,44876,114811,299636,1143819
u,m,1995,10557,200273,60910,3824,11340,12922,88996
u,m,1800,69,780,116,12,63,14,205
u,m,1824,688,15277,1307,112,549,304,2272
f,f,1901,2897,531241,103000,8749,21373,65833,198955
f,m,1802,11,477,213,23,110,332,678
f,u,1936,5785,578202,196052,15200,36507,109743,357502
m,m,1817,277,25433,4816,356,1362,3128,9662
u,m,1893,7841,315150,37227,2536,11201,5613,56577
f,m,1984,7274,703328,272047,18683,48157,137764,476651
u,f,1827,500,10154,1197,100,483,307,2087
m,f,1908,5756,737427,146916,11234,31971,73873,263994
m,u,1936,16785,1153022,382388,29766,74850,201726,688730
u,u,1913,1417,35250,5872,463,1482,1175,8992
u,f,1861,579,13670,1709,192,589,425,2915
u,m,1803,147,2368,286,26,109,62,483
u,u,1977,20097,320506,98120,7515,21132,20738,147505
m,u,1954,17970,1437876,541266,37596,101064,264097,944023
f,f,1848,661,213938,28413,2684,7888,25067,64052
u,f,1833,610,21045,1635,155,690,478,2958
m,f,1854,1664,223072,43584,4109,11717,30062,89472
f,f,1946,3927,601074,197619,14330,34103,102357,348409
m,f,1867,3118,508403,80799,7386,21518,48475,158178
m,m,1989,28218,2410699,922215,57164,152869,408451,1540699
m,m,1912,16141,2282986,469861,34399,103963,233114,841337
f,u,1803,80,10322,1313,122,495,1389,3319
f,u,1850,16,1484,278,26,70,251,625
u,u,1887,255,6276,723,45,205,175,1148
f,m,1823,534,74469,10238,1016,3360,10214,24828
f,m,1935,5586,572743,208075,15937,40016,115828,379856
u,m,2011,70,7555,1332,20,259,226,1837
u,u,1886,480,12643,1210,146,412,312,2080
m,m,1865,3589,542872,81035,6775,22357,51578,161745
f,f,1893,3924,922137,166856,14979,37364,110307,329506
m,f,1833,1262,163714,27362,2493,8418,20173,58446
f,m,1977,5869,495688,202012,13853,35042,101735,352642
f,m,1953,5458,607067,216431,15005,38651,105631,375718
u,m,1924,7085,127873,27435,2062,6824,6620,42941
u,m,1921,7381,228503,36213,2681,9010,8414,56318
m,m,1992,18080,1109294,525281,34941,89989,240227,890438
m,m,1952,18024,1743759,621846,42759,108367,274893,1047865
f,m,1839,580,88270,12607,915,4002,11259,28783
u,m,1976,11059,211500,54038,3325,10506,10697,78566
f,f,1886,3009,616881,117318,10669,26810,84101,238898
m,f,1999,11701,770545,375967,26523,66715,167444,636649
u,m,1817,219,6069,723,74,293,177,1267
m,f,1937,5796,542198,184165,13642,34638,85061,317506
u,f,1882,2164,78084,9902,809,2794,2388,15893
u,u,1866,111,2101,261,25,99,72,457
m,u,1974,23819,1258530,560416,41077,109372,266286,977151
u,m,2002,10305,155892,54625,3555,9884,10965,79029
m,m,1902,9822,1165804,222168,16809,54660,122718,416355
m,f,1977,6000,478775,177148,13406,33345,79667,303566
f,m,1886,2465,494052,92582,8182,23177,63198,187139
f,m,1986,6761,689076,271762,16986,45478,139586,473812
m,u,1985,32670,1622477,726493,52919,135551,350360,1265323
f,u,1894,341,49813,12714,951,2520,8780,24965
m,u,1881,715,71294,14500,1346,3923,8735,28504
m,f,1906,5510,755196,150725,11202,33183,82783,277893
u,m,2004,11577,166687,57110,3898,11066,12987,85061
f,f,1977,3058,375578,146108,10644,25853,75233,257838
f,u,1895,415,55861,12222,1027,2873,9542,25664
m,f,1816,488,94371,15326,1073,4905,10563,31867
f,u,1944,3813,327941,122673,8970,22067,66431,220141
f,u,1937,4890,538047,207997,15882,38697,118991,381567
f,m,1867,1081,213112,37814,3816,10322,27295,79247
u,u,1980,18657,326376,100866,6839,20270,20780,148755
m,f,1868,2433,343634,67403,5903,17015,39732,130053
u,f,1807,237,2665,734,42,343,133,1252
m,m,1947,22255,2078435,680320,47948,119421,312300,1159989
m,f,1886,5329,695809,128342,11714,30354,76344,246754
m,f,2010,6,0,60,2,8,54,124
u,f,1815,376,23737,1977,154,651,352,3134
m,m,1809,346,21085,4916,372,1616,3521,10425
u,u,1819,95,779,424,44,202,85,755
u,m,1842,1106,53879,4286,320,1538,796,6940
f,u,1808,139,17309,2072,216,822,1485,4595
m,f,1956,5695,603345,203945,15116,37227,88289,344577
u,f,1916,2815,79404,12553,1036,3203,2824,19616
f,m,1928,4730,512657,170387,13734,35731,95600,315452
u,f,1998,5029,96839,30233,1855,5695,7245,45028
f,m,1905,3135,500206,96424,7592,21497,60099,185612
u,u,1885,351,9495,1110,132,329,318,1889
f,u,1973,8548,498463,259335,20826,51491,143886,475538
m,m,1827,1256,177427,21711,1989,6830,18137,48667
m,f,1848,990,183577,26362,2262,7124,17827,53575
m,m,1924,13774,1375132,442653,32321,88023,225449,788446
u,f,1965,2958,62384,17266,1173,3519,3676,25634
u,m,1917,5736,142244,24661,1996,6425,5401,38483
f,m,1902,3040,545171,99256,7491,23828,64077,194652
m,f,1822,617,102815,20596,1639,5962,15757,43954
f,u,2003,9444,613803,293550,20970,55318,168902,538740
f,f,1866,1417,379688,61915,6013,15233,47960,131121
u,m,1928,8434,154374,36401,2752,8993,7787,55933
u,u,1912,1087,34558,5271,410,1242,1134,8057
m,m,1956,18986,1755766,623745,40625,104085,271499,1039954
u,u,1850,54,5146,371,14,117,45,547
m,m,1839,2043,310326,38200,2649,11697,28324,80870
f,u,1851,176,22514,3570,337,1001,3458,8366
m,m,1887,7399,959669,187315,15797,44192,106751,354055
m,u,1858,1628,210036,30445,2716,7488,19219,59868
u,m,1911,6514,170926,23893,1834,6352,5167,37246
m,f,1894,5638,769777,139240,12159,33477,80649,265525
f,u,1920,1086,167313,35196,2855,7438,21604,67093
m,f,1991,10024,537118,283542,20496,51072,127572,482682
f,u,1999,12985,778035,388545,27694,70812,224791,711842
u,f,1977,3091,83771,22922,1446,3920,4703,32991
f,u,1831,105,13257,1972,253,575,1932,4732
u,m,1912,7441,215507,29777,2281,7587,6687,46332
m,u,2010,1548,66646,31898,2446,6576,15802,56722
f,u,1882,697,80194,14070,1316,3593,10515,29494
m,f,1819,255,23273,4179,377,1386,3169,9111
f,u,1990,15803,1065373,492043,35954,88913,271946,888856
u,f,1873,1121,29042,3643,402,1040,833,5918
f,f,1989,7019,883004,384211,25589,63562,202765,676127
u,m,1978,12284,235981,67633,4211,12530,12935,97309
m,f,2001,11582,791728,363820,25454,66449,171735,627458
f,u,1837,84,20450,1620,88,509,1227,3444
m,u,1906,1636,196617,37735,3044,9021,20992,70792
m,m,1835,2004,303181,38734,3092,11817,31353,84996
f,f,1864,1373,359293,59991,5124,15025,45214,125354
m,u,1851,489,47252,5851,535,1642,4547,12575
m,u,1835,404,45880,5552,391,1713,4744,12400
m,u,1873,614,77539,13872,1247,3565,8229,26913
m,u,1971,26001,1432363,583772,43134,113790,297285,1037981
m,m,1815,507,58802,7698,631,2308,6088,16725
u,m,2014,0,0,0,0,0,0,0
f,u,1993,15235,904721,464745,33542,84671,259336,842294
m,f,1942,5293,573052,172137,13144,32636,77784,295701
m,f,1905,4125,486296,103119,7661,22087,55861,188728
f,m,1970,8047,642513,261236,18887,47904,132282,460309
m,u,1909,1582,173631,35646,2807,8151,20410,67014
u,u,1892,680,16037,2156,188,646,681,3671
f,u,1988,13026,916522,403823,30387,75397,226639,736246
u,m,1891,5070,157257,19365,1828,5205,4015,30413
f,u,1950,8055,916222,320986,25070,66231,184045,596332
m,u,1852,407,74610,10483,904,3022,7022,21431
m,m,2002,19724,1256074,592079,36716,98348,269872,997015
f,f,1898,3385,706418,122299,10542,27809,86606,247256
f,f,1980,4543,596461,268222,18552,44631,140300,471705
f,m,1864,1269,237785,40020,3706,11663,30157,85546
m,u,1806,77,1355,1173,125,393,1100,2791
u,m,1970,12874,236369,70620,4391,12705,14299,102015
f,f,1819,178,18458,3096,320,1056,3146,7618
u,u,1877,185,5776,387,62,125,82,656
u,m,1852,2210,76981,6016,597,2140,1072,9825
m,m,1851,2326,359641,52152,3809,16376,32794,105131
f,u,1954,5859,626419,222817,16005,40509,117394,396725
u,u,1874,146,1959,236,37,86,92,451
m,m,1920,15937,2031932,467514,34322,100063,227506,829405
u,f,1914,3266,92305,14371,1072,3393,3186,22022
u,u,1914,1111,37440,4664,359,1230,1030,7283
f,f,1913,4535,972504,189858,13829,39695,117515,360897
u,m,1807,68,2106,319,18,84,86,507
f,m,1903,3323,539949,105740,7877,24456,66930,205003
m,u,1887,595,66561,11669,1002,2889,7478,23038
m,u,1905,2090,232486,41254,3297,10157,23450,78158
u,u,1865,287,8431,1001,105,319,370,1795
f,m,1849,764,89155,14930,1487,4641,12337,33395
u,f,1897,3497,131297,15639,1351,4310,4027,25327
m,u,1878,600,73930,14692,1084,3571,7920,27267
m,f,1873,2618,398762,71384,6505,17729,40349,135967
u,f,1991,4974,87993,30108,2286,5934,6990,45318
m,u,1980,29575,1584844,710023,49983,129553,341902,1231461
m,f,1806,201,23549,5789,385,1862,4929,12965
f,u,1929,6839,809267,253623,19414,55793,159832,488662
m,f,1932,4305,424833,152318,11724,30204,78081,272327
f,m,1828,455,67348,8161,740,2760,8440,20101
f,m,1844,1066,230336,29187,2098,10292,24219,65796
u,f,1811,90,2197,373,15,123,101,612
m,u,1821,234,25095,5743,422,1767,5360,13292
u,f,2004,5390,100801,35397,2505,6373,7991,52266
u,u,1805,10,18,23,3,6,1,33
u,f,1926,1623,27163,7203,558,1885,1749,11395
m,u,1871,575,66096,11473,1085,2854,6951,22363
m,u,1832,1040,93053,11783,1031,3417,11463,27694
f,m,1872,2188,386953,57618,4859,15886,40107,118470
m,m,2000,24430,1554190,733882,47502,124952,337607,1243943
f,u,1883,328,43524,6877,684,1873,5329,14763
f,f,1887,2871,583794,115789,10804,27276,83499,237368
u,u,1867,327,7680,689,62,240,165,1156
f,f,1994,6518,702573,379339,23269,59055,200586,662249
u,f,1821,218,11174,1286,82,464,511,2343
u,f,1868,1004,30900,3100,314,957,746,5117
f,f,1847,628,175459,29853,2673,8686,26373,67585
f,u,1967,11725,1020241,408390,30878,80514,234214,753996
m,f,1998,10815,729392,330456,23619,61693,159601,575369
u,f,2011,0,0,0,0,0,0,0
m,u,1901,2785,368840,65581,5286,16006,35728,122601
u,f,1880,2828,104041,13880,1024,4122,3447,22473
u,f,1921,2332,79608,11283,900,2878,2599,17660
u,f,1952,3251,69048,18999,1414,4255,4484,29152
f,f,1944,3213,560215,174449,12382,30166,89532,306529
m,f,1974,5638,451798,180743,13485,34107,84920,313255
m,m,1819,825,102623,10791,871,3141,9404,24207
m,m,1984,24075,2155571,796295,51231,134381,358925,1340832
u,f,1905,1975,55307,7751,588,1917,1790,12046
m,u,1838,257,22463,3071,228,983,2447,6729
f,f,1865,1841,521079,88989,8177,22022,65761,184949
m,u,1841,203,21885,4491,324,1408,2899,9122
u,f,1816,262,5463,777,63,286,162,1288
u,m,1968,13447,215531,69849,4408,13851,13922,102030
f,f,1894,3124,756467,127774,10792,29060,88911,256537
u,u,1844,126,2271,432,39,178,88,737
u,m,2006,10989,134846,53954,3395,10576,11819,79744
f,f,1882,2272,507725,94622,8362,22612,65696,191292
m,m,1979,23233,2123104,763639,47104,127361,336851,1274955
m,m,1814,21,205,149,9,37,85,280
u,u,1864,297,6128,577,70,177,169,993
u,m,1874,1711,62930,6197,579,1926,1380,10082
f,m,1852,1468,284967,35824,3245,11138,29212,79419
f,u,1913,866,140522,28067,2402,6070,16854,53393
m,m,1929,17316,1585985,520502,37939,105001,258145,921587
m,f,1965,4979,477429,187720,13188,35052,82830,318790
f,u,1869,184,40586,6645,597,1701,6037,14980
u,m,1925,6824,139537,31810,2387,7255,7016,48468
m,f,1975,6330,439988,175060,13415,34214,77371,300060
f,m,1968,7694,640593,264536,19809,49646,137381,471372
u,u,1809,13,32,15,1,5,3,24
f,f,1976,3462,372606,150318,11719,27284,77841,267162
m,m,1995,20789,1674494,659003,40967,111166,303213,1114349
u,f,1800,93,2184,266,32,108,52,458
u,u,1847,92,2086,281,27,102,60,470
u,m,1810,342,6050,785,82,264,219,1350
u,f,1810,455,10556,1644,82,576,431,2733
f,m,1975,5712,502214,200690,13182,36031,103032,352935
f,f,1960,2661,309236,131061,9370,22392,65480,228303
u,m,1828,695,24116,1794,156,630,476,3056
u,m,1839,911,30480,2735,191,935,570,4431
u,u,1936,10449,176305,42537,3227,9471,9465,64700
m,f,1901,5313,597114,116987,9303,25665,64252,216207
f,f,1805,69,11527,3375,210,1354,3296,8235
f,m,1909,3921,674872,131965,10287,30205,79728,252185
m,m,1874,3554,524847,86799,7631,21985,51578,167993
m,f,1881,3758,423858,93135,8191,23466,52246,177038
m,u,1825,421,50978,7100,828,2092,5764,15784
m,m,1906,11505,1605499,306503,22049,67959,161668,558179
f,f,2009,3501,193531,186214,12604,30875,103586,333279
u,m,1846,1369,25094,2951,280,1073,577,4881
m,m,1883,11728,1350313,236296,21134,60809,148125,466364
f,u,1819,96,9259,2868,211,995,2482,6556
u,u,1882,1138,22084,2409,207,661,652,3929
m,f,1889,5245,771535,140486,13138,34269,81292,269185
f,m,1889,2778,434171,85246,7442,21085,58026,171799
m,f,1902,4289,505030,97416,7670,21855,56938,183879
m,m,1821,760,83974,13234,997,3696,10449,28376
u,f,1985,5225,191432,44108,2726,7972,10946,65752
f,u,1827,176,29042,3958,439,1204,2884,8485
u,m,2007,10382,155911,50909,3268,9994,10928,75099
f,u,2012,0,0,0,0,0,0,0
u,f,2013,0,0,0,0,0,0,0
m,m,1800,148,29705,4550,341,1418,3135,9444
u,m,1843,822,24990,2060,184,718,353,3315
u,u,1944,7620,135840,34792,2498,7529,7869,52688
u,u,1890,521,15052,1881,192,512,447,3032
u,m,1897,6212,190616,23643,1875,6737,5132,37387
f,u,1893,437,64492,13171,1195,2901,9681,26948
f,u,1923,4689,541758,160259,12894,36417,106501,316071
f,f,1808,66,11674,1608,141,577,1717,4043
