chargender,authgender,date,characters,speaking,agent,mod,patient,poss,total
f,m,1919,4281,765663,171470,13496,36245,98509,319720
m,u,1994,31530,1738040,774261,55982,146659,381423,1358325
f,m,1941,3961,409174,146282,10644,27440,77008,261374
f,u,1843,106,29208,3386,292,1144,3314,8136
u,m,1922,8531,193825,33048,2598,8381,7340,51367
u,m,1931,6698,149782,32172,2380,7768,7037,49357
u,u,1862,175,4217,328,39,107,99,573
m,u,1812,93,11828,1978,191,643,1794,4606
f,m,1827,460,56630,7985,836,2897,8129,19847
f,f,1897,3352,673536,126772,11096,27604,89006,254478
u,u,1980,16355,309609,91411,6019,18099,18749,134278
m,f,1996,15237,1039346,438179,29947,78477,191662,738265
u,u,1977,18507,298952,90893,7065,19697,19405,137060
f,m,1822,239,19170,4443,394,1369,4130,10336
m,f,1810,648,92398,19217,1220,6468,16549,43454
u,m,1967,12909,210235,63874,4118,12798,13124,93914
m,u,1875,433,31829,7589,669,2045,4155,14458
f,m,1954,6222,647068,236429,17182,42520,117455,413586
m,u,2011,31,1795,34,8,23,0,65
f,f,1878,1576,350516,69070,6337,15911,50835,142153
m,m,2014,0,0,0,0,0,0,0
f,u,1866,227,50826,7335,680,1919,5163,15097
m,f,1856,2306,363895,54660,5151,14338,37665,111814
m,f,1990,14586,1167198,440294,31404,82748,202226,756672
f,f,1950,3575,532010,205709,14031,33825,100012,353577
f,m,1962,6742,639044,220532,15869,40182,107954,384537
f,m,1922,6517,1046576,246391,19395,51256,142321,459363
u,f,1934,3071,41394,12269,1094,3058,2888,19309
m,u,1950,20158,1972113,651600,46673,134838,336444,1169555
u,m,1963,10969,167121,54623,3743,10928,10457,79751
f,m,1879,898,174898,34359,2951,8689,23245,69244
f,u,1998,9936,658376,317342,23030,59307,186359,586038
m,u,1869,346,40046,8782,779,2191,6350,18102
f,m,1804,192,15955,3356,289,1093,2979,7717
m,m,1870,3804,625164,95628,7689,26529,60311,190157
u,f,1985,6654,207979,49353,3041,9062,12098,73554
u,f,1967,3414,70083,20355,1360,3870,3802,29387
u,f,1959,3010,110290,24998,1566,4477,4880,35921
u,u,1860,495,36018,2661,240,866,526,4293
m,u,1896,1130,133843,23346,1884,5672,12258,43160
u,m,1935,9826,212628,55326,3949,11623,11524,82422
u,m,2003,12460,159887,59261,4013,12393,12946,88613
f,m,1928,4905,520378,175712,14028,36800,98231,324771
m,m,1836,2343,282681,31170,2516,9321,25098,68105
m,m,1908,11461,1708289,352236,25105,76124,183422,636887
u,u,1811,109,8015,581,41,199,89,910
f,m,1868,1133,153679,27827,2607,8313,21256,60003
u,u,2002,16912,280162,85378,5936,16454,20131,127899
f,u,1914,698,121787,22633,1749,5141,14400,43923
m,m,1802,19,1725,460,26,133,483,1102
f,u,1926,5305,560170,184864,15415,40623,114235,355137
f,f,1916,3715,936272,183805,13758,36715,106198,340476
u,m,1821,357,16643,1206,78,374,240,1898
m,m,1992,22441,1265875,592070,39886,102296,266141,1000393
f,u,1991,12487,828593,398947,29619,76882,228516,733964
f,f,2007,8597,808656,441387,28524,71773,240154,781838
f,f,1912,4144,892659,163218,12530,34464,101714,311926
f,m,1963,6548,452788,207012,15067,39173,106601,367853
m,u,1957,19191,1653765,574473,43272,110438,273939,1002122
m,u,1845,414,64725,6385,451,2039,5113,13988
f,f,1976,4202,421387,168399,12927,30422,84614,296362
f,u,1944,3391,311525,114825,8461,20781,63096,207163
u,m,1886,3378,88394,11279,963,3369,2555,18166
m,f,1927,3903,388223,126256,10379,26805,63038,226478
u,u,1857,353,9297,949,94,302,181,1526
f,m,1884,2603,409248,88101,8072,21670,60074,177917
f,f,1955,3527,475023,176721,11653,28932,83741,301047
f,f,1931,3035,400803,150135,11942,28965,86205,277247
f,m,1935,5749,579557,210812,16176,40455,117123,384566
u,m,1928,9092,163575,38931,2939,9493,8391,59754
f,u,1861,155,19089,3277,249,1008,3576,8110
f,f,1887,2871,583794,115789,10804,27276,83499,237368
u,u,1814,27,107,17,1,9,1,28
m,m,1852,4445,667757,89397,7715,25631,63040,185783
u,m,1889,4600,116948,13195,1179,4020,3200,21594
u,u,1989,21274,394602,122342,8536,25623,26219,182720
m,m,1915,13157,1977187,401692,27540,86565,198865,714662
f,u,1962,8351,748223,276752,21010,53426,152566,503754
f,f,1856,1494,389974,59110,5207,15229,48627,128173
f,u,1883,328,43524,6877,684,1873,5329,14763
u,f,1897,3497,131297,15639,1351,4310,4027,25327
m,m,1901,10766,1443218,260282,19262,62230,145295,487069
f,u,1966,7914,669807,271092,20699,52649,156060,500500
u,u,1910,1099,26721,4166,320,971,987,6444
u,u,1825,199,4193,411,51,138,137,737
m,u,1871,575,66096,11473,1085,2854,6951,22363
m,m,1993,24101,1399378,668117,44403,116116,298359,1126995
f,f,1913,4535,972504,189858,13829,39695,117515,360897
f,m,1881,1895,408257,73839,7004,18123,49919,148885
m,f,1878,3031,444157,75177,7038,17601,44538,144354
f,m,1988,8874,791298,318272,20507,55220,166936,560935
u,f,1803,86,2543,418,40,158,110,726
m,m,1849,2575,303557,44770,3719,13138,31530,93157
f,m,1959,6184,616847,213543,14754,37676,106541,372514
u,u,1959,13410,291375,69439,4564,15535,14183,103721
f,m,1921,4934,845019,199393,15551,43061,116916,374921
u,f,1926,1905,30393,8419,643,2144,1944,13150
m,f,1820,654,71915,17838,1513,5397,12577,37325
m,m,1948,18907,1864576,640375,42898,108515,282773,1074561
f,f,2000,7283,786618,404944,26835,64994,214197,710970
m,m,1810,575,39430,11788,1074,3799,9320,25981
u,m,1903,5095,136667,18922,1464,5267,3997,29650
u,f,1806,123,7129,1126,64,365,363,1918
u,f,1993,5969,132987,42632,2891,7390,10348,63261
m,f,1880,3853,433061,94822,8471,23976,57526,184795
m,f,1847,1238,152471,21372,1753,6626,16295,46046
m,u,2004,23714,1101806,535885,39105,104249,275101,954340
u,u,1932,8891,222956,46315,2803,10346,9576,69040
u,u,1841,83,1964,208,18,82,53,361
u,m,1870,2055,64304,7496,660,2304,1359,11819
u,m,1882,3448,78608,10500,1013,3212,2779,17504
u,u,1997,17894,384482,100818,7193,19974,21756,149741
u,u,1879,703,21023,1811,181,556,327,2875
u,f,1828,170,5477,545,37,199,115,896
f,f,1958,3114,384134,134669,9234,22782,67270,233955
u,u,1873,221,1259,243,41,98,62,444
u,f,1906,2933,94377,13386,995,3111,3067,20559
m,u,1858,1628,210036,30445,2716,7488,19219,59868
f,m,1825,759,119329,15358,1306,5132,15089,36885
u,f,2006,7127,134103,51085,3289,9120,10715,74209
m,u,1973,20999,1075287,512358,38221,102719,258736,912034
f,m,1812,128,13662,1790,140,686,1516,4132
f,u,1933,4949,564811,188442,15639,38703,112758,355542
m,m,2008,19078,1027215,613864,38802,104783,282333,1039782
m,u,1978,24536,1663826,634960,43993,120460,321985,1121398
u,f,1812,201,3465,691,60,286,212,1249
f,u,1968,10402,832515,349559,26248,72039,204611,652457
m,u,1841,203,21885,4491,324,1408,2899,9122
m,m,1960,19018,1605533,593775,39940,102413,254267,990395
f,m,1906,3986,621444,135412,10124,29745,83478,258759
m,m,1973,23611,1714784,695487,45118,115629,315476,1171710
m,u,1987,24213,1197098,558852,41206,106492,274935,981485
m,m,1979,26029,2250682,818179,50952,137162,358707,1365000
u,m,1811,198,6751,494,48,204,117,863
u,m,1980,13981,283501,76413,4969,14755,16625,112762
m,f,1875,3215,424526,91864,7955,22988,55178,177985
m,f,1833,1262,163714,27362,2493,8418,20173,58446
u,u,1967,23543,361776,105310,7528,25788,21983,160609
f,m,2006,7568,462371,268206,18063,45844,141744,473857
u,m,1822,248,7991,512,45,170,114,841
f,m,1923,4838,585291,191369,15329,39581,113121,359400
u,f,1864,1216,42283,4178,378,1328,1021,6905
m,m,1845,2331,351800,45207,3592,13528,32425,94752
m,m,1864,3722,572132,85960,7381,25017,54855,173213
u,f,1862,520,18686,2414,203,691,627,3935
m,m,1917,12197,1570123,351870,24872,73938,178450,629130
f,u,1938,3837,423460,162991,11461,29502,88839,292793
u,f,2014,0,0,0,0,0,0,0
f,f,1973,4075,343870,170908,12763,30712,85410,299793
u,u,1963,16615,369989,92624,6009,19266,18076,135975
f,f,1925,1990,251204,101657,7970,20546,58997,189170
f,u,1952,6120,693223,240222,19293,49003,140544,449062
f,m,1801,168,15717,2440,239,1154,2542,6375
f,u,2010,499,32820,12530,972,2324,7137,22963
m,u,1965,25010,1607411,665166,47988,128690,330229,1172073
u,m,2006,12669,159522,66161,3970,12709,13965,96805
u,u,1935,7348,160501,38997,2845,8423,8591,58856
u,f,1887,2880,106349,11665,1055,3552,2806,19078
f,u,1980,8793,654942,279372,20856,52278,157246,509752
m,f,2004,14375,952692,441176,30744,78853,191595,742368
m,m,1900,10076,1147447,218869,16470,51786,122763,409888
f,u,1928,5086,598306,210848,17107,44532,130075,402562
f,u,1943,3959,391598,137993,10315,25026,71246,244580
f,m,1832,412,95515,12496,1069,4146,10979,28690
u,u,1968,23386,377825,119028,8398,26816,24180,178422
f,m,1956,5969,643842,230435,15469,40379,115386,401669
f,f,1868,1455,342499,63425,5401,15533,47231,131590
m,f,2012,0,0,0,0,0,0,0
f,f,1978,4207,502135,214599,15097,35219,111562,376477
m,f,1968,7466,588456,234946,16681,42218,100743,394588
m,u,1816,196,14770,2674,233,910,2230,6047
u,f,1904,2592,97002,12467,861,2812,2622,18762
f,f,2006,7971,809534,439676,27885,69480,238888,775929
f,m,1894,4180,678967,122714,9826,30107,78864,241511
u,f,2003,6952,130553,46550,3077,8493,9954,68074
m,f,1911,6371,831885,170745,13079,37318,85874,307016
m,u,1852,407,74610,10483,904,3022,7022,21431
f,u,1890,406,56546,9872,923,2410,7058,20263
m,u,1825,421,50978,7100,828,2092,5764,15784
f,u,1812,78,8021,2705,239,813,2326,6083
u,u,1871,181,2973,410,33,145,93,681
u,f,1956,3459,78062,22647,1695,4371,4119,32832
f,m,1992,6932,492457,232953,15557,40068,116130,404708
m,m,1871,3265,466008,81054,7020,21039,51167,160280
f,m,1952,6226,687073,241495,17521,44227,120788,424031
f,u,1995,10557,741112,312588,22709,61375,187933,584605
u,f,1850,529,17451,1648,163,540,397,2748
m,u,1894,698,77432,17478,1621,3808,10476,33383
f,m,1839,580,88270,12607,915,4002,11259,28783
f,u,1807,47,3851,954,126,355,1096,2531
u,m,1997,15129,222202,71267,4914,14685,16667,107533
m,f,1814,863,80549,19426,1582,5777,16775,43560
m,u,2000,25099,1200668,559996,40658,111038,286575,998267
m,u,2007,26333,1423613,665996,45402,122008,330450,1163856
f,f,1983,4529,507615,237025,16725,39361,117628,410739
f,m,2001,7699,547125,256528,17053,44420,135586,453587
f,m,1931,4102,466658,153319,11300,30737,84551,279907
f,m,1927,5553,625432,210321,16111,44373,124961,395766
m,f,1925,3437,244881,102083,8418,21353,48769,180623
f,u,1939,3007,309169,101735,7315,19702,56930,185682
u,m,1904,5371,118770,19660,1559,5447,3765,30431
f,f,1905,2399,462086,90575,6632,18574,56414,172195
f,u,2001,8465,613065,274180,18922,49250,165870,508222
u,f,2013,0,0,0,0,0,0,0
f,m,1967,7295,596239,259338,18328,47440,131839,456945
m,u,1948,18525,1386746,528832,39718,105708,260312,934570
u,f,2009,3104,36909,21182,1275,3954,4746,31157
m,f,1930,5261,396822,152957,11762,32003,71735,268457
f,m,1951,6308,648284,239090,17092,44420,120126,420728
u,f,1998,6620,131802,35805,2338,7022,8444,53609
f,f,1917,4017,875423,178032,13652,36693,101979,330356
m,u,1986,28061,1568547,641139,47018,124684,319258,1132099
f,m,1933,4820,495270,173925,14285,34594,95997,318801
m,u,1917,2043,241814,49218,4073,11585,25801,90677
f,u,1959,6293,516528,185813,14381,38126,110611,348931
u,m,1932,7554,148934,35340,2482,8120,7686,53628
u,f,1996,8086,139943,43680,2913,8589,10365,65547
m,u,1870,475,78323,12169,1064,3397,7731,24361
f,u,1923,4463,532675,157088,12648,35644,104812,310192
u,m,1879,1135,32259,3411,319,1030,750,5510
f,f,2012,0,0,0,0,0,0,0
u,f,1954,3612,78944,20730,1497,4556,4319,31102
f,m,1877,1432,268226,40517,3785,10914,29707,84923
f,u,1889,402,60680,11946,1070,2895,9755,25666
u,f,1936,3676,61901,16270,1246,3806,3935,25257
m,f,1912,6741,840186,172516,13186,37288,91424,314414
m,u,1934,10134,756085,273598,20932,54617,141916,491063
f,f,1986,5605,698666,291946,19762,48489,154461,514658
f,f,1855,1218,336820,52524,4356,13737,44883,115500
f,f,1895,2935,625349,121754,10258,26095,81136,239243
u,m,1829,1910,89260,5197,451,1743,1208,8599
u,f,1827,500,10154,1197,100,483,307,2087
u,u,1880,275,4725,614,64,181,169,1028
m,m,1876,4540,723542,114080,9710,30205,72789,226784
m,u,1838,257,22463,3071,228,983,2447,6729
m,m,1830,2228,306474,38503,3046,11963,32789,86301
m,f,1959,5544,470329,167454,12101,30199,73328,283082
m,u,1802,57,8322,1282,102,438,1100,2922
m,m,1897,12091,1482870,280853,21421,65008,153925,521207
u,u,1971,15502,356337,86810,5651,18816,18797,130074
f,m,1971,7092,467263,204306,14836,37928,106058,363128
m,f,1954,7851,649038,248088,17778,46693,114797,427356
u,m,1944,6128,87998,24732,1831,5691,4680,36934
m,m,1841,2368,364594,47036,3549,15767,34241,100593
m,u,1960,21372,1760344,665712,45036,127790,336357,1174895
f,f,1989,8138,944528,415287,27785,68883,217378,729333
u,u,1865,287,8431,1001,105,319,370,1795
u,m,1954,9662,175057,47851,3129,9050,8865,68895
m,u,1979,26324,1656173,624226,45058,120821,306244,1096349
f,f,1979,5323,619398,267272,19858,46611,142080,475821
f,f,1953,3286,451904,165080,11170,27419,82116,285785
m,u,1804,20,1057,677,43,229,689,1638
f,f,1872,1791,375071,60631,5781,15347,45144,126903
f,u,1830,522,64947,6946,733,2386,7155,17220
m,m,1898,15406,2115983,367677,27599,91098,213147,699521
u,u,1828,139,4489,257,22,81,63,423
f,u,1960,8035,695117,294981,21877,57305,162046,536209
u,f,1981,5106,109600,31211,2047,5933,7309,46500
u,m,1988,16324,363044,90302,5540,16497,19843,132182
m,m,1848,3049,448239,57364,4442,16217,41512,119535
m,m,1991,24342,1460598,678336,45047,117196,310139,1150718
m,m,1965,24950,1922115,720815,47141,123250,326621,1217827
f,m,1851,673,115272,17417,1406,5543,13731,38097
f,u,1999,10485,645310,323797,23198,60346,195936,603277
f,m,1800,85,17294,2222,150,806,1846,5024
u,f,1951,3381,67400,18046,1390,3814,3419,26669
f,u,1899,490,83415,14169,1096,3419,9920,28604
u,u,1833,84,5202,247,24,122,91,484
m,f,1900,5448,636377,125390,9884,28033,69389,232696
f,m,1886,2465,494052,92582,8182,23177,63198,187139
u,f,1947,3177,53927,15014,1154,3318,3196,22682
m,m,1938,13541,1305678,432492,30559,79525,200877,743453
m,m,1815,507,58802,7698,631,2308,6088,16725
u,f,1921,2332,79608,11283,900,2878,2599,17660
m,u,1956,18940,1609860,577480,41350,110395,280099,1009324
m,m,2000,28863,1691576,795351,52060,135957,364247,1347615
m,u,1868,1070,153990,29222,2157,7515,16774,55668
f,m,2009,4804,248283,172057,11371,29638,87047,300113
m,m,1888,8905,1231033,211441,16720,52661,126037,406859
m,m,1995,24984,1839328,724089,45919,122879,330478,1223365
m,f,2002,13839,901946,406353,28822,72264,182451,689890
m,m,1866,5147,903077,149886,11766,36926,90158,288736
m,u,1919,2359,249710,61030,4893,12358,30660,108941
f,u,1862,328,73930,11494,988,2704,8083,23269
u,f,1960,3670,59865,17981,1369,3957,3675,26982
m,m,1819,825,102623,10791,871,3141,9404,24207
f,m,1901,3285,632776,108413,7987,24827,66848,208075
m,u,1989,30293,1604994,735161,52263,138125,363497,1289046
m,m,1835,2004,303181,38734,3092,11817,31353,84996
f,m,1864,1269,237785,40020,3706,11663,30157,85546
u,f,1958,3532,71532,21009,1368,4109,4052,30538
m,m,1854,3798,433460,60254,5072,17564,43863,126753
m,m,1893,13347,1901998,323660,25331,81821,180358,611170
f,u,1872,462,76318,13188,1293,3520,10046,28047
f,f,1888,2313,482808,90168,8328,21837,64341,184674
m,m,1896,17945,1837741,345221,27380,84206,198771,655578
f,f,1849,528,106843,17469,1422,4901,15605,39397
m,u,1889,940,90266,19693,1718,4802,12343,38556
f,f,1801,149,19969,2819,267,1275,3439,7800
m,u,1998,25432,1187260,581474,42828,113824,300797,1038923
m,m,1887,7399,959669,187315,15797,44192,106751,354055
u,f,1886,2311,75570,9206,872,2602,2270,14950
u,u,1933,7003,122359,30005,2315,7012,6249,45581
f,m,1854,1183,155498,22168,1976,6589,19167,49900
f,u,1822,110,23404,3496,174,1402,4370,9442
u,u,1854,432,16969,1336,108,481,308,2233
f,f,1810,338,58023,13213,1021,4859,13872,32965
f,u,1877,213,30050,5320,478,1347,3895,11040
m,f,1860,2399,281092,49358,4508,13186,32960,100012
f,u,1811,72,12413,2273,166,721,2542,5702
u,m,1806,86,2463,99,21,46,52,218
f,m,1957,5693,570971,207470,14063,37707,99772,359012
f,u,1971,7724,534023,232270,18280,46893,138197,435640
f,u,1907,467,69168,15299,1372,3716,9295,29682
m,u,1876,825,105422,14514,1313,3867,10135,29829
m,u,1921,2239,322878,74431,5529,15803,35758,131521
m,u,1857,992,118971,20205,1834,5343,14401,41783
m,f,1867,3118,508403,80799,7386,21518,48475,158178
m,f,1966,6722,630840,220863,15133,38126,92309,366431
u,u,1927,8084,139582,33423,2689,8956,6640,51708
f,u,1951,6324,660173,262449,20249,50738,149016,482452
u,f,1913,3133,99284,14579,1142,3688,3758,23167
f,f,1863,1161,341848,58435,5009,14771,42274,120489
u,m,1972,11481,191572,55378,3765,10907,11714,81764
m,u,1855,926,100761,17273,1605,4938,12019,35835
u,u,1823,30,355,123,8,28,17,176
m,u,1964,20866,1527164,580270,41298,113568,293131,1028267
f,m,1840,883,107969,19533,1665,6553,16763,44514
m,f,1916,6165,822458,178353,14059,38558,89135,320105
u,m,1812,1240,29983,6137,484,2152,1074,9847
u,f,1875,1479,31806,5672,550,1576,1596,9394
m,f,1815,867,196649,22594,1680,6626,16425,47325
u,m,1808,308,9857,1328,115,497,484,2424
m,u,1981,26323,1587520,601604,43964,118530,296820,1060918
f,m,1856,1468,218859,32630,2919,9873,24966,70388
m,f,1955,7246,650083,222999,15334,40286,98349,376968
f,m,1862,640,86098,14669,1301,4150,12227,32347
u,f,1975,4005,84151,20583,1321,4080,4548,30532
f,m,1811,223,17788,5483,456,1945,5831,13715
m,f,1819,255,23273,4179,377,1386,3169,9111
f,f,1911,3593,772162,148072,11517,31044,90079,280712
f,f,1941,3541,512964,162324,11848,29019,87677,290868
u,u,2009,3980,45834,19670,1409,3880,4404,29363
m,f,1907,5343,575693,122548,9513,26841,66930,225832
f,u,1879,513,115913,20130,1957,5346,15595,43028
u,m,1865,1608,39120,4320,365,1385,1018,7088
m,f,1920,7497,898534,201035,16344,43969,101848,363196
u,m,1941,6530,124967,30780,2258,6768,6879,46685
u,m,1923,7064,130242,32813,2510,8152,7299,50774
f,f,1808,66,11674,1608,141,577,1717,4043
f,f,1836,709,162753,23577,2083,7330,22424,55414
u,u,1996,19773,328996,94849,6443,20195,22743,144230
f,m,1874,1066,181957,35500,3327,9445,25188,73460
u,u,1945,8080,203052,44345,2987,9299,8409,65040
u,m,1872,3537,81019,7470,751,2421,1750,12392
m,m,1884,7505,832118,162312,14337,41127,97086,314862
u,u,1800,13,76,22,1,6,2,31
m,m,1892,11604,1357728,250676,21361,61284,145845,479166
u,f,1933,2256,47476,12125,905,2781,2747,18558
u,m,1801,300,9011,940,79,360,218,1597
u,u,1842,117,1385,197,30,45,50,322
f,f,1935,3486,451939,175310,13241,32538,95600,316689
m,u,1888,1130,125582,19632,1602,4936,12115,38285
m,u,1819,169,29894,4306,330,1552,3170,9358
u,u,1896,508,10392,1499,108,407,348,2362
m,f,1803,172,15090,3980,312,1379,3335,9006
f,f,1944,3496,572966,180980,12796,31171,92188,317135
f,f,1966,3401,393801,148264,10372,24677,69145,252458
m,f,1874,2346,354573,62444,5594,15812,34457,118307
m,u,1805,11,110,65,8,21,88,182
m,u,1837,167,20730,2506,182,793,1900,5381
f,m,1918,3853,539801,127967,9942,26595,72699,237203
u,m,1956,10976,178384,50339,3594,10396,9341,73670
f,m,1905,3135,500206,96424,7592,21497,60099,185612
f,f,1831,381,93755,12986,1131,4057,12014,30188
f,m,1857,1583,251202,36927,3087,11346,31265,82625
m,f,1854,1664,223072,43584,4109,11717,30062,89472
u,m,1826,950,33405,2382,159,777,726,4044
m,u,1846,396,31001,3342,302,1132,2626,7402
m,u,1815,268,17470,3474,272,1098,2595,7439
f,u,2014,0,0,0,0,0,0,0
u,m,1933,9227,255668,46001,3380,9887,8675,67943
u,f,1952,3948,86487,23639,1754,5077,5342,35812
u,f,1844,620,13211,1753,181,627,394,2955
m,u,1951,17750,1559726,593868,44063,115825,293266,1047022
m,f,1841,1761,216692,36488,3104,11038,26975,77605
u,f,1866,1143,41050,3428,417,1076,849,5770
f,u,2003,7770,528958,256210,18168,48547,150099,473024
f,u,1814,16,10178,1501,113,407,1326,3347
m,f,1834,1113,217651,26511,2267,7935,17387,54100
u,u,1801,8,6,4,4,4,1,13
m,u,1893,1170,113422,24918,2008,5971,14923,47820
f,u,1901,943,195934,33699,2801,7696,22795,66991
f,u,1945,4860,498863,173032,12673,30696,90993,307394
f,m,1870,1251,234939,39203,3402,10697,28614,81916
m,m,1983,27578,2027663,763078,48413,130616,334293,1276400
f,u,1970,11476,963611,357915,27422,72763,210692,668792
m,u,1982,25904,1636523,635130,46670,122512,317025,1121337
u,u,1994,21711,358194,113210,8269,24096,26115,171690
f,f,1981,5559,731270,301194,19770,49420,156225,526609
u,m,2001,12434,180554,61780,3802,11583,13340,90505
f,f,1827,789,191456,29580,2237,9723,23956,65496
m,u,1922,6512,417608,161685,11622,36625,82902,292834
u,m,1895,7220,179957,24602,2039,7241,5513,39395
u,m,1946,9651,204965,47108,3150,9364,9650,69272
f,u,1880,369,43970,8689,832,2059,6778,18358
m,u,1887,595,66561,11669,1002,2889,7478,23038
u,f,1860,948,22900,3947,399,1226,1026,6598
m,u,1916,2172,232409,52793,4035,11982,29020,97830
u,u,1902,1487,47493,5755,451,1560,1170,8936
f,m,1893,3909,619310,110580,9579,28823,72605,221587
f,f,1875,2194,430754,87659,7884,21278,66907,183728
f,f,1846,650,170315,24161,2103,7136,20396,53796
f,m,1809,97,1008,1233,91,476,1160,2960
f,u,1915,589,95113,20434,1592,4961,12557,39544
f,f,1920,4303,932988,208708,15515,41779,120910,386912
m,m,1844,4451,817965,97356,6762,31352,67951,203421
u,m,2011,70,7555,1332,20,259,226,1837
f,u,1997,10096,633462,310700,22642,59545,181448,574335
u,m,1843,822,24990,2060,184,718,353,3315
m,f,1886,5329,695809,128342,11714,30354,76344,246754
m,u,1882,2068,173681,28374,2446,7451,18881,57152
m,m,1981,27010,2223568,826194,52846,136988,357017,1373045
u,u,2014,0,0,0,0,0,0,0
f,u,1847,77,7969,1420,123,480,1295,3318
m,u,1874,393,49669,8199,701,2185,5404,16489
f,m,1838,514,80664,11488,994,3763,10719,26964
u,u,1937,7499,159639,36797,2882,8261,7215,55155
u,m,1827,557,19579,1799,247,588,433,3067
f,m,1932,5000,513837,198066,15664,38900,105537,358167
f,m,1946,6120,634207,225341,16397,40660,112401,394799
u,u,1864,297,6128,577,70,177,169,993
m,f,1921,5542,738425,178333,13765,38380,85849,316327
m,f,1831,669,81215,10965,958,3300,8344,23567
u,u,1869,155,4425,617,50,147,203,1017
m,u,1880,770,98604,16119,1497,4434,9930,31980
m,m,1860,3422,512007,71891,6207,21186,49966,149250
m,u,1899,1438,159059,29397,2308,6890,17060,55655
f,f,2011,0,0,0,0,0,0,0
m,m,1811,448,43042,8508,634,2705,6910,18757
f,f,1999,8216,860962,414144,27352,67133,218695,727324
m,m,2002,23571,1350659,640152,40548,107581,288367,1076648
u,u,1915,1245,45856,6864,556,1580,1313,10313
f,u,1896,398,79135,14771,1281,3367,8390,27809
u,m,1962,10422,167924,50799,3283,10042,9157,73281
u,m,1800,69,780,116,12,63,14,205
f,f,1954,3818,532300,199097,13505,33706,102271,348579
m,f,1978,8161,675390,258905,19025,47190,121871,446991
u,f,1834,438,16563,1383,111,470,322,2286
m,m,1857,4740,800850,98283,7849,27795,67089,201016
u,f,1922,3777,101446,18749,1562,4183,4277,28771
f,f,1949,3600,603181,201582,14063,33635,100316,349596
m,f,1876,3015,465338,84220,7551,21071,50387,163229
m,u,1955,19059,1643675,578812,40637,107047,287372,1013868
f,m,1846,786,125213,17839,1392,5841,14872,39944
m,m,1925,14534,1553185,457174,34606,90510,245523,827813
m,u,1814,40,7755,994,92,298,679,2063
m,m,1846,2893,460326,58198,4203,17881,43183,123465
u,m,2009,7730,109123,44540,2817,8185,8948,64490
m,u,1924,10682,754636,257713,20285,54197,139179,471374
m,f,1981,10423,879983,335194,23233,60451,148900,567778
f,m,1817,131,15917,2697,234,854,2115,5900
u,u,1926,8163,156495,37198,2895,9332,7707,57132
m,f,1936,7607,661087,225325,17635,45315,107653,395928
f,f,1885,2164,475471,93188,8288,22624,66577,190677
f,m,1859,1604,235373,32198,2924,9304,27320,71746
f,u,1932,3957,395306,149063,11965,30301,89627,280956
f,u,1935,4496,496920,182553,14339,35500,110589,342981
f,u,1855,602,126096,20903,1856,6059,17173,45991
u,u,1993,22460,359303,123417,8812,25118,28290,185637
m,u,1851,489,47252,5851,535,1642,4547,12575
u,u,1884,230,4869,671,101,218,106,1096
m,m,1998,23244,1494143,672734,42220,112983,316961,1144898
u,u,1868,437,6698,1345,124,450,195,2114
f,f,1894,3124,756467,127774,10792,29060,88911,256537
f,m,1858,860,151113,22525,1993,7204,17495,49217
f,u,1809,17,519,245,30,87,215,577
u,f,1858,844,23419,3312,308,932,672,5224
m,f,1983,9142,620319,274324,19918,49451,124000,467693
u,m,1817,219,6069,723,74,293,177,1267
u,f,1832,478,16167,1176,117,453,352,2098
m,u,1895,1053,102369,23980,2046,5658,13922,45606
u,f,1982,6036,168513,47469,3209,8710,10752,70140
m,f,1991,12434,642273,334587,24561,61277,147877,568302
u,m,1818,290,7175,488,43,197,137,865
u,f,1854,702,15173,1874,214,635,380,3103
m,m,1958,19006,1874210,672424,43967,115065,283116,1114572
m,f,1830,787,116640,15616,1340,4395,12652,34003
u,u,1912,1087,34558,5271,410,1242,1134,8057
u,f,1925,1703,31339,9086,728,2036,2128,13978
u,u,1890,521,15052,1881,192,512,447,3032
m,u,1878,600,73930,14692,1084,3571,7920,27267
m,f,2013,0,0,0,0,0,0,0
u,m,2004,12795,182065,61192,4184,11895,13713,90984
m,f,1958,6715,585483,203657,14508,35871,86309,340345
m,f,1998,13982,859043,392398,28238,73685,186838,681159
m,f,1938,7289,669451,216560,17660,43487,103316,381023
f,u,1981,9247,720903,304059,23632,58806,168877,555374
u,f,2007,7852,111457,42027,2968,8401,9589,62985
f,f,1984,5190,636152,268075,17623,43368,136799,465865
u,f,2005,7228,131186,45050,2971,8289,9727,66037
f,f,1948,3608,571547,202365,14770,34295,101618,353048
m,f,1832,1307,168457,28501,2485,7924,21267,60177
m,m,1829,4431,678530,65299,5210,18691,55299,144499
m,m,1881,5826,873221,143386,12609,35761,83067,274823
m,f,1949,6995,704629,227681,16346,40822,102040,386889
u,m,1951,9770,237631,54968,3710,10909,9621,79208
u,u,1847,92,2086,281,27,102,60,470
m,m,1874,3554,524847,86799,7631,21985,51578,167993
m,f,1986,10655,863754,316099,22372,57824,141227,537522
f,u,1823,91,21768,3566,301,996,2987,7850
u,m,1858,1577,63413,6611,450,2109,755,9925
m,f,2008,14587,689854,454096,32120,85351,210571,782138
m,u,1937,12512,1085028,357629,25769,69201,176698,629297
u,f,1935,3203,65699,18428,1477,4142,3706,27753
f,m,1808,151,13069,2998,290,1179,3765,8232
f,f,1886,3009,616881,117318,10669,26810,84101,238898
m,u,1983,27933,1722621,679885,48088,131564,338283,1197820
u,m,1985,13357,297302,77913,4513,13831,16118,112375
m,m,1807,160,9938,2537,186,853,2195,5771
u,u,2001,15698,271221,88193,6230,18234,20523,133180
u,m,1974,13052,214677,63660,4198,13005,12577,93440
u,f,1963,3380,57416,17927,1222,3646,4251,27046
u,m,1907,5347,165584,22540,1568,6051,4682,34841
m,u,1971,20893,1215810,497941,36672,98040,263141,895794
u,u,1946,13618,311712,63515,4544,14081,12629,94769
f,f,1826,313,74829,10542,879,3323,10310,25054
u,m,1987,14503,249970,77397,4865,14586,16447,113295
m,u,1811,131,17825,3845,284,1110,3548,8787
m,m,1916,13772,2025244,433143,30258,94112,217083,774596
u,f,1816,262,5463,777,63,286,162,1288
u,m,1957,9600,181457,46792,3197,9008,9067,68064
f,u,2006,9608,625640,331596,22190,55709,192705,602200
u,f,1869,1108,39084,4124,387,1268,1002,6781
m,u,1822,498,48657,5170,318,2030,4598,12116
u,f,1802,51,8060,401,37,187,102,727
m,f,1902,4289,505030,97416,7670,21855,56938,183879
u,m,1863,1238,38483,3522,344,1311,805,5982
f,f,1991,6834,638492,331439,23175,55649,169941,580204
f,m,1985,7256,775416,277898,17680,47940,134366,477884
u,m,1891,5070,157257,19365,1828,5205,4015,30413
m,f,1950,7306,642023,244655,17812,45007,108067,415541
u,f,1917,3139,102131,16003,1109,3640,3354,24106
u,f,1805,74,1479,260,15,99,37,411
u,m,1906,5265,142112,20863,1699,5610,4541,32713
m,f,1802,138,17685,3189,316,1031,2500,7036
f,f,1852,1009,278852,45852,3570,11390,39539,100351
f,f,1830,417,83010,13519,1131,3969,14066,32685
f,f,1965,2966,351902,138791,9923,24336,66908,239958
f,m,1831,817,162248,17339,1370,5238,16476,40423
f,f,2013,0,0,0,0,0,0,0
f,f,1918,3912,804123,173406,13113,35825,99549,321893
f,m,1987,8386,747423,288881,19555,50546,146072,505054
m,m,1805,95,8796,1426,111,509,1212,3258
u,f,1891,2373,69483,8260,732,2399,1991,13382
f,f,1938,3608,621172,225363,15777,38538,129603,409281
f,f,1891,2857,677099,120986,10583,27181,83385,242135
m,m,1921,15303,2168130,495687,35462,103020,258708,892877
u,f,1863,722,16075,1948,182,606,434,3170
f,u,1865,424,65950,12013,1042,2850,8367,24272
m,m,1968,27368,2062908,830799,55799,142007,358577,1387182
m,m,1920,15937,2031932,467514,34322,100063,227506,829405
m,m,1936,15340,1479664,473879,33664,88365,231223,827131
u,f,1801,104,1310,259,24,79,71,433
m,f,1976,8072,598562,224834,16890,41235,93602,376561
u,u,2007,17583,285275,95394,6318,19180,22135,143027
u,m,1816,142,6743,394,50,157,88,689
f,f,1857,1376,340602,61142,5499,16420,48377,131438
u,m,1898,8478,269949,35084,2741,10252,7702,55779
m,u,1930,16256,1460009,481404,35139,105273,257613,879429
u,u,1883,422,12963,1290,119,409,340,2158
f,m,1865,1125,203916,31095,2580,8498,22481,64654
u,f,1874,958,29595,3741,327,1073,981,6122
m,m,1955,21731,1972738,730268,48593,123893,316742,1219496
u,f,1847,562,13221,1300,109,448,287,2144
m,u,1925,11296,897817,283801,21925,65118,157724,528568
u,u,1942,6525,117957,31917,2249,6884,6540,47590
f,m,1872,2188,386953,57618,4859,15886,40107,118470
m,u,1827,352,41543,5948,587,1666,4246,12447
f,u,1870,182,39548,5786,474,1471,4838,12569
u,f,1815,376,23737,1977,154,651,352,3134
u,u,1982,18965,382944,99328,6915,20482,21175,147900
f,f,1816,266,97949,12396,956,4299,10485,28136
m,u,1929,18890,1425756,469090,36340,102727,260423,868580
f,f,1937,3276,446723,188278,13230,30684,95874,328066
u,f,1964,3352,65044,21912,1590,4295,4537,32334
f,f,1972,2996,307573,115598,8079,20242,59390,203309
u,m,1877,2337,87543,8123,652,2479,1950,13204
u,u,1832,507,14230,1205,103,389,396,2093
u,m,1894,7243,198580,23561,1857,6858,4468,36744
u,f,1890,2808,96944,11075,1072,3460,2529,18136
m,f,1892,5119,678083,129856,12037,30680,75628,248201
u,f,1912,3296,80525,12812,1051,3425,2986,20274
f,u,1927,4393,393370,152450,12200,32895,92754,290299
m,m,1853,4279,363179,48717,4036,14607,34932,102292
f,f,1811,120,37586,7987,563,2586,7257,18393
f,f,1889,3057,701095,130150,11976,29921,91322,263369
m,f,1908,5756,737427,146916,11234,31971,73873,263994
u,m,1918,6554,169134,26044,2029,6384,5249,39706
f,m,1895,4479,734343,137297,11637,32853,87137,268924
m,u,1854,855,112405,15636,1357,3873,9274,30140
m,m,1928,16375,1527749,473656,34248,95351,242589,845844
m,u,1908,1858,208541,41763,3130,9341,22064,76298
m,m,1834,2720,494168,46523,3458,13722,37627,101330
u,u,1813,4,25,4,0,2,4,10
u,m,1809,223,3387,425,36,156,81,698
f,f,1877,1522,298180,59613,5708,15006,46028,126355
m,m,1803,305,11096,2274,220,886,1581,4961
m,u,1958,15417,1212588,469888,32534,88179,236337,826938
u,m,1839,911,30480,2735,191,935,570,4431
u,m,1912,7441,215507,29777,2281,7587,6687,46332
m,f,1918,6574,761796,179894,13401,37096,84966,315357
u,m,1908,5189,142263,23082,1787,5743,4606,35218
m,m,1878,5793,617741,108857,9693,29178,69541,217269
u,m,1940,6849,149764,36588,2485,7488,7486,54047
u,u,1807,55,591,118,15,43,25,201
f,u,1993,12984,790403,410550,29518,75310,234076,749454
m,f,1891,4970,690150,125793,11345,30205,72408,239751
u,f,1937,3028,76056,19771,1571,3947,4119,29408
m,m,1832,1417,266310,34163,2905,10418,26025,73511
u,f,1929,2903,63206,17859,1473,3818,3428,26578
m,m,1940,14544,1655504,527071,34373,90516,229682,881642
f,f,1939,2471,330534,123713,8887,21752,62221,216573
m,f,1863,1846,303935,54281,4726,14304,33251,106562
f,f,2004,7874,740935,363329,25191,60816,189435,638771
f,f,1951,3866,631741,208131,14255,34518,100245,357149
f,u,2009,2709,144189,104846,7412,19704,59127,191089
m,u,1824,191,16067,3729,320,1087,2437,7573
m,m,1822,662,74650,10057,803,2879,7567,21306
m,u,1997,25994,1305957,611090,44335,120978,307293,1083696
m,f,1901,5313,597114,116987,9303,25665,64252,216207
m,f,1987,13027,1153249,414010,28604,74336,189044,705994
m,m,1820,689,68529,9665,762,2873,7096,20396
f,f,1934,3399,427117,164981,13126,30449,92311,300867
m,m,1827,1256,177427,21711,1989,6830,18137,48667
u,f,1811,90,2197,373,15,123,101,612
f,f,1867,1733,392927,71222,6933,17243,52571,147969
f,m,1940,4160,449546,164707,11915,30921,81685,289228
f,f,1896,3553,733162,127176,11188,28343,87142,253849
f,u,1800,5,348,27,0,7,12,46
f,u,1908,714,164079,29717,2150,6529,19481,57877
m,m,1850,3896,646396,81503,6539,24919,57677,170638
u,m,2008,10054,127758,54718,3226,9652,12456,80052
m,f,1816,488,94371,15326,1073,4905,10563,31867
f,m,1824,478,53262,8017,702,2654,7853,19226
u,u,1907,826,21287,3783,281,809,766,5639
u,m,1976,12379,219243,57291,3578,11296,11503,83668
m,f,1842,1139,132755,21412,1955,6337,15976,45680
f,u,1833,87,10656,2020,174,704,2116,5014
u,m,1949,8780,162469,39397,2606,7933,8040,57976
m,m,1862,2167,253104,42605,3664,11275,29534,87078
u,u,1957,12232,318708,74380,5190,16078,14893,110541
u,u,1804,30,173,96,6,38,17,157
f,u,1937,4400,516066,196391,14939,36502,113259,361091
f,m,1976,6795,585711,237936,16042,42296,120405,416679
u,m,1998,11557,211806,58817,3306,10761,12806,85690
f,u,2007,9996,609573,334219,22921,59011,189365,605516
f,m,2002,7188,540212,256732,16598,44306,137216,454852
m,u,1823,81,7314,1336,153,396,1146,3031
u,u,1898,434,7682,1009,124,340,299,1772
f,m,1986,7436,733309,290850,18269,48958,148412,506489
f,f,1909,3438,733658,136532,10482,29062,83516,259592
u,m,1866,2309,81804,7597,710,2393,1477,12177
m,m,1990,31945,2688914,982754,62995,167293,436950,1649992
u,m,1830,1100,39439,3013,284,1217,651,5165
u,m,1848,1452,43649,3934,325,1449,865,6573
m,u,1850,51,5744,563,45,147,438,1193
m,u,1988,27479,1542399,656153,48452,123918,329133,1157656
u,m,1950,11084,295594,65844,3764,12442,12807,94857
u,u,1924,7288,144611,33797,2454,8390,6635,51276
m,f,1835,2638,351867,56949,5040,15716,40937,118642
f,m,1867,1081,213112,37814,3816,10322,27295,79247
f,m,1847,589,124189,19169,1517,5905,15419,42010
m,u,1890,989,82617,16656,1507,4197,10215,32575
f,u,1925,4051,471667,157819,11758,34114,100671,304362
f,u,1931,5599,502878,195830,16499,41670,119191,373190
m,f,1957,6729,595488,223516,16480,40361,91551,371908
m,f,1889,5245,771535,140486,13138,34269,81292,269185
m,u,1833,164,17625,3102,245,916,2169,6432
m,u,1839,559,81659,10325,729,3462,7474,21990
u,f,2011,0,0,0,0,0,0,0
f,f,1968,3750,414176,173729,11704,29200,85938,300571
u,f,1983,5102,104579,29736,1813,5326,6813,43688
f,u,1921,858,168889,35008,2781,7447,20160,65396
u,f,2000,7001,108523,41342,2795,8024,9533,61694
m,f,1992,12559,758503,359170,25469,64335,160753,609727
m,f,1807,268,38999,11850,699,4200,10392,27141
m,m,1828,1272,201049,20992,1678,6999,18236,47905
m,f,1985,12909,1032094,379517,26258,68877,174899,649551
m,u,1867,637,76002,13992,1063,3739,9293,28087
f,f,1992,6663,707100,351234,22132,54957,177815,606138
m,u,1928,14297,1036205,395394,29574,84517,220145,729630
m,f,1858,1752,283221,47666,3882,12317,31463,95328
u,m,1835,990,38203,3068,301,1006,701,5076
u,u,1838,105,2701,175,17,44,42,278
m,m,1812,439,54309,8040,526,2703,5874,17143
u,f,1837,311,10048,782,74,275,232,1363
u,f,1948,3172,65667,18735,1325,3954,3570,27584
f,f,1952,3600,451509,166161,12221,29482,85478,293342
f,f,1839,590,108384,17464,1509,5063,16527,40563
u,f,1969,3791,61988,20207,1328,3928,4096,29559
f,f,1940,2620,410024,141326,9915,23875,67883,242999
u,f,2004,6961,118045,41679,2966,7782,9384,61811
u,m,1938,6917,136218,33509,2493,7148,6821,49971
m,m,1910,15985,2233305,432490,30702,98379,221249,782820
m,m,1972,21333,1496902,602750,39649,104252,265316,1011967
u,f,1849,545,14855,1487,135,454,495,2571
m,m,1949,18466,1815082,584218,39084,103317,259391,986010
f,m,1807,75,8958,1528,120,516,1700,3864
u,f,1856,890,21216,2790,267,823,795,4675
f,u,1958,4854,475754,183514,13303,35105,103261,335183
f,f,1960,3109,351457,144375,10180,24482,70040,249077
u,f,1821,218,11174,1286,82,464,511,2343
f,m,1900,3230,442746,87613,7025,21198,56451,172287
f,m,2004,8378,535479,293437,19614,50518,153880,517449
f,m,1938,4010,406653,147926,11238,27871,73570,260605
u,m,1981,14864,309731,77814,5331,14682,16576,114403
f,m,1961,7192,626491,248930,18090,46447,123369,436836
u,f,1896,4210,167408,20322,1536,5614,4292,31764
u,m,1921,7381,228503,36213,2681,9010,8414,56318
m,u,1927,11956,830221,281659,22718,61825,154974,521176
f,f,1933,2565,330227,132697,9948,23439,73369,239453
f,u,1983,10495,794278,340649,25415,64069,186381,616514
u,m,1807,68,2106,319,18,84,86,507
f,m,1891,3108,530635,98805,8478,23295,66163,196741
m,f,1913,7368,1014316,205166,15740,44785,107061,372752
u,f,1957,3175,70529,21298,1600,4234,4239,31371
m,m,1957,18574,1753851,621815,39370,103318,260863,1025366
u,f,1979,5470,137878,43974,2459,7745,10008,64186
f,u,1996,11402,799381,360634,27343,68280,210013,666270
m,m,1932,15458,1562490,510611,37796,98185,238270,884862
m,f,2011,0,0,0,0,0,0,0
m,m,1997,26876,1912209,809721,51450,141553,374368,1377092
u,f,1971,3401,52709,15969,1132,3257,3589,23947
u,f,1907,2871,77007,11210,895,3025,2578,17708
m,m,1858,2724,399946,55316,4556,16170,36661,112703
f,m,1821,221,24698,3442,302,1175,3176,8095
f,u,1813,33,7042,1787,146,574,1660,4167
f,m,1983,7296,576644,247990,16778,43815,125606,434189
m,f,1895,5276,681202,125135,10695,30410,67894,234134
m,u,1842,207,25510,2881,262,837,2401,6381
f,f,1842,563,129621,21311,1927,6192,18681,48111
f,m,1974,6816,451122,193254,14099,36076,98746,342175
u,m,1846,1369,25094,2951,280,1073,577,4881
m,m,1873,3019,440572,71127,5803,19194,44274,140398
m,f,1848,990,183577,26362,2262,7124,17827,53575
f,m,1892,3701,572178,113891,9817,28330,77122,229160
f,m,1972,6159,437995,185876,13412,35349,94353,328990
m,u,1990,34388,1865362,786290,56654,148022,405738,1396704
f,f,1848,661,213938,28413,2684,7888,25067,64052
u,m,1825,1389,46954,3846,321,1333,921,6421
f,m,1816,65,11422,1511,116,516,1631,3774
u,u,2008,9313,126897,47592,3455,9464,10631,71142
u,m,1978,13472,242205,69560,4423,13085,13458,100526
m,u,1865,888,102809,19507,1766,4971,11595,37839
m,u,1923,13380,1043099,324574,23975,73621,183596,605766
u,m,1841,1081,39828,3083,220,1205,662,5170
f,f,1906,3036,670224,129427,10200,26656,81502,247785
f,f,1943,3331,516574,173150,11884,28905,82045,295984
u,u,1929,14267,269058,60339,4302,15028,12631,92300
m,m,1869,3983,395809,67582,6409,18726,43724,136441
m,m,1813,125,6530,974,73,399,500,1946
u,f,1808,82,3157,348,21,143,34,546
u,m,1960,10208,183467,53007,3294,10467,10157,76925
f,f,1980,5554,674089,302183,20860,50496,155323,528862
u,m,1892,6278,196669,21294,1791,6673,4324,34082
f,f,1812,356,82106,14215,1281,5020,12626,33142
u,f,1911,2933,86712,14170,1133,3524,3538,22365
f,u,1805,7,218,60,3,26,86,175
m,f,1829,902,139395,15839,1440,4975,12801,35055
f,f,1969,3787,437317,183825,13069,30636,86896,314426
u,u,2013,0,0,0,0,0,0,0
f,m,1978,7779,733942,293222,19559,51124,142524,506429
m,f,1839,970,115153,16948,1370,4894,13571,36783
u,f,1972,3627,69713,17503,1263,3571,3618,25955
f,u,1806,18,116,264,30,115,374,783
m,f,1956,6586,662823,225410,16600,40878,96472,379360
u,u,1950,14890,395107,85298,5460,17798,16503,125059
u,m,1850,1938,73241,5790,486,2058,1344,9678
m,m,1956,20715,1838802,657105,42727,110035,284441,1094308
f,m,1930,5613,608085,197216,16124,41078,112322,366740
u,u,1837,116,7633,572,55,194,75,896
m,u,2006,23518,1240754,598539,40804,107169,302046,1048558
u,f,1838,585,17158,1136,142,528,348,2154
m,f,1809,453,78383,12775,1083,4156,9333,27347
f,f,1843,437,95540,12924,1108,4207,11931,30170
m,f,1883,4793,536295,113198,11066,27852,64502,216618
f,u,1955,5938,737095,245204,17673,46364,136948,446189
f,m,1925,4484,606796,196169,15556,40131,118722,370578
f,f,1837,413,92468,13979,1223,4129,13377,32708
m,f,1946,8474,879026,270235,19206,47998,117090,454529
m,f,1838,1190,158806,20932,1970,6928,17402,47232
m,u,1891,1004,107124,20983,1857,5421,13663,41924
m,f,2001,13568,910060,416616,28790,75672,193687,714765
f,f,1998,7890,732198,374448,25031,60926,203995,664400
u,f,2010,205,2915,728,44,185,159,1116
u,u,1855,349,5859,884,93,299,253,1529
u,m,1880,3235,98493,10419,886,3079,2681,17065
m,m,1882,6839,752126,145692,13404,36545,89936,285577
u,m,1834,1300,65720,3810,292,1266,792,6160
f,f,1866,1417,379688,61915,6013,15233,47960,131121
u,f,1918,3006,66233,11862,947,2851,2889,18549
f,m,1826,489,93092,10641,800,3268,10460,25169
m,u,1906,1636,196617,37735,3044,9021,20992,70792
f,m,1875,916,207965,38789,3434,10154,27231,79608
u,u,1812,44,2063,120,16,50,40,226
f,u,1853,305,52368,8364,705,2427,6792,18288
f,u,1869,184,40586,6645,597,1701,6037,14980
u,u,1983,20133,401394,111706,7313,22289,23437,164745
m,u,1944,10737,718389,249336,17910,46336,122056,435638
m,f,1906,5510,755196,150725,11202,33183,82783,277893
f,u,1950,7439,854970,297886,23620,62818,174263,558587
m,f,1909,6258,788841,157482,12555,35292,80242,285571
m,u,1946,21679,1680840,568984,41622,105845,280012,996463
u,f,1833,610,21045,1635,155,690,478,2958
f,f,1910,3694,780399,152682,11956,31552,97061,293251
f,u,1878,218,29420,6314,540,1560,4838,13252
f,u,1882,697,80194,14070,1316,3593,10515,29494
m,f,1812,451,81035,13453,1122,4479,10221,29275
m,m,1950,20200,2350896,726496,46547,123214,329546,1225803
u,m,1916,6198,158589,25005,1961,6540,5973,39479
f,m,2008,5972,356038,229194,15239,40417,121465,406315
u,u,1949,11546,206600,54464,3788,11802,10190,80244
u,u,1824,42,443,51,3,21,18,93
f,f,1961,3244,416093,155530,10534,25462,76080,267606
m,f,1910,6693,835704,164106,13243,35904,87056,300309
u,m,1979,13971,260623,71577,4543,13657,15865,105642
u,m,1820,348,13187,1416,109,377,277,2179
f,m,1912,5217,928326,183321,14609,40208,106412,344550
m,u,1843,376,72475,7955,556,2319,5778,16608
f,m,1949,5532,583235,197353,14798,36842,101107,350100
u,u,1981,18073,320066,90820,6154,18434,20927,136335
u,m,1874,1711,62930,6197,579,1926,1380,10082
m,f,1811,169,8219,3471,242,1124,2989,7826
m,f,1974,7518,551808,224674,16811,42224,102158,385867
f,u,1922,2396,211785,79578,6004,18187,47920,151689
u,f,1898,2726,87942,10269,913,2614,2443,16239
f,f,1963,3212,379185,160367,10929,26856,77604,275756
f,u,1994,13199,927429,447439,32595,81854,254663,816551
f,m,1998,7462,514492,254601,16789,44387,140140,455917
u,u,1911,1311,20379,4075,370,1166,910,6521
f,m,1815,183,43800,3741,333,1027,3128,8229
f,u,2008,5480,374046,195331,15126,38655,114164,363276
m,f,1801,205,18582,4908,401,1693,3963,10965
f,u,1851,176,22514,3570,337,1001,3458,8366
u,m,1986,13414,268635,69906,4397,13087,13938,101328
u,f,1872,1133,34017,3404,334,1218,964,5920
f,u,1913,866,140522,28067,2402,6070,16854,53393
f,f,1820,379,61021,18881,1319,5939,14673,40812
f,m,2011,32,4590,1139,25,172,509,1845
m,u,1932,11968,917632,297011,21921,61177,158740,538849
f,m,1843,470,67277,8596,706,2872,7582,19756
f,f,1946,4309,643476,208532,15369,36091,107050,367042
u,m,1842,1106,53879,4286,320,1538,796,6940
u,f,1946,3834,73746,18792,1476,4084,3782,28134
f,m,1950,6435,742223,242557,16836,43656,121521,424570
f,f,1829,577,126956,19111,1645,5767,18105,44628
m,u,1902,2600,235166,45549,3724,11120,25920,86313
f,m,1991,7421,540780,266141,17975,46254,141752,472122
f,f,1879,1317,321592,63368,6190,14133,44170,127861
f,f,1995,7240,747979,366983,23543,59476,190864,640866
m,f,1923,2736,255942,80566,6177,16662,39363,142768
f,f,1962,3056,412252,148284,10521,24583,69876,253264
u,m,1896,9622,310368,32692,2642,9802,6759,51895
u,u,1882,1138,22084,2409,207,661,652,3929
f,u,1864,449,72127,11189,1030,2594,8257,23070
u,f,1809,279,7101,950,79,328,247,1604
u,m,2013,16,0,181,23,63,41,308
f,u,1804,14,1744,890,43,270,927,2130
f,m,1913,5288,952617,191748,14775,41781,114730,363034
f,f,1861,840,142632,23671,2350,6405,18694,51120
f,u,1832,433,41732,6404,576,2080,7600,16660
u,m,1955,11825,212742,61412,4229,11911,11286,88838
u,u,1876,346,10950,1170,127,387,330,2014
m,u,1864,971,117048,17175,1553,4220,10231,33179
u,f,1986,5573,132297,36358,2221,6414,8345,53338
u,m,1814,30,1026,175,16,59,36,286
u,m,1991,13007,228992,71428,4857,15293,15582,107160
f,u,1912,687,93255,20644,1684,4659,13149,40136
f,u,1837,84,20450,1620,88,509,1227,3444
m,m,1944,12374,1056437,367612,25902,64230,161782,619526
m,m,1934,16599,1714302,546167,39738,106002,265667,957574
m,m,1954,20243,1845513,673232,44234,111931,288758,1118155
m,f,1999,14713,921687,444417,31406,78541,196740,751104
f,u,1969,12286,1029460,374412,30542,75590,219591,700135
f,f,1914,3598,819325,150666,11106,31867,93529,287168
f,f,1814,535,114367,22651,1791,7373,21425,53240
u,f,1941,3016,76259,17683,1195,3407,3880,26165
m,u,1913,2172,233809,44316,3686,10339,22836,81177
u,u,1851,205,7022,498,33,163,120,814
m,u,1992,33662,1776158,829955,59899,158897,423212,1471963
m,f,1972,6469,434175,177254,12535,31361,78241,299391
f,m,1955,6588,758937,242119,17590,43512,119887,423108
f,f,1892,3366,756468,150241,13936,34096,103254,301527
f,u,1904,783,141703,26127,2090,5781,17740,51738
m,f,1837,720,88903,13890,1162,4192,11298,30542
u,f,1813,239,17568,1558,99,631,507,2795
m,u,1801,27,5024,798,80,274,565,1717
m,u,2005,25556,1253373,584102,41993,113990,296664,1036749
m,u,1847,270,39376,4830,405,1945,3981,11161
m,m,1926,15796,1299186,403702,30312,83696,214453,732163
m,u,1915,1565,187438,37885,2712,9079,19769,69445
u,f,1893,2976,98833,11446,1068,3191,2875,18580
m,m,1861,1622,238577,37435,3092,9647,22821,72995
u,u,1958,12340,302705,84339,5448,16758,16389,122934
f,u,1916,815,149260,31172,2364,6786,19927,60249
u,f,1852,562,29124,3178,241,675,896,4990
f,u,1887,267,46164,7317,658,1791,5554,15320
u,u,1903,1175,23957,3544,328,986,788,5646
m,f,1884,4265,554155,107254,9922,24988,61851,204015
f,u,1946,6881,587970,233335,18208,43910,129121,424574
m,m,1818,630,57287,6465,575,2099,4771,13910
m,m,2004,25594,1545306,739110,47191,124521,335469,1246291
u,f,1919,2924,97563,12940,1094,3550,3399,20983
f,u,1842,80,9033,1277,101,386,1260,3024
f,u,1982,8934,754324,303001,23248,58118,167460,551827
u,u,1815,123,5449,680,59,271,314,1324
u,u,1809,13,32,15,1,5,3,24
u,m,1952,9924,211178,53678,3801,10993,11295,79767
u,m,1853,2134,48751,5959,485,2012,1548,10004
f,m,1835,571,110173,13921,1127,4428,12805,32281
m,f,1905,4125,486296,103119,7661,22087,55861,188728
m,m,1895,14453,1825748,323078,24871,79721,183707,611377
m,u,2003,20345,1242414,509693,35476,97076,256767,899012
u,u,1944,6946,131535,32591,2323,6897,7563,49374
u,u,1874,146,1959,236,37,86,92,451
f,f,1834,726,202689,27847,2306,7993,23757,61903
f,m,1910,4641,753648,149511,11463,32872,89800,283646
u,u,1819,95,779,424,44,202,85,755
f,u,1818,97,11603,2544,295,883,2926,6648
u,f,1879,995,32426,4017,416,1146,1008,6587
u,u,1966,17866,377765,99552,6637,20966,21442,148597
m,m,1985,24879,2087642,777053,48785,131745,334507,1292090
u,m,1983,15183,394161,92514,5387,16959,19173,134033
m,m,1839,2043,310326,38200,2649,11697,28324,80870
m,f,1827,1287,196748,29328,2073,8944,21390,61735
m,m,1899,21010,2490966,441120,34337,107114,252899,835470
m,u,1974,19505,1109404,487102,35064,95425,234834,852425
m,u,1907,1188,115042,25535,2053,5996,14241,47825
m,m,1946,20227,1754495,612991,42012,106464,270517,1031984
m,u,1938,11950,840193,331668,24122,64230,166990,587010
f,m,1876,1482,292431,50975,4362,13532,40115,108984
u,f,1885,1605,43795,6459,631,1851,1683,10624
m,f,1915,7271,994983,204319,15833,45800,105819,371771
u,u,1916,1397,57774,8274,583,2456,1528,12841
u,m,1900,5314,151659,19663,1580,5739,4276,31258
f,f,1977,3713,429769,166774,11997,29146,83416,291333
f,f,1822,452,89950,14879,1283,4940,13811,34913
u,m,1984,15322,275490,99969,5521,18034,22312,145836
u,m,1936,7300,107861,29197,2232,6993,6778,45200
f,m,1823,534,74469,10238,1016,3360,10214,24828
m,m,1808,335,48266,6914,601,2292,7273,17080
m,f,2009,6629,245776,221527,15541,41425,103752,382245
u,m,1873,1560,57852,5499,489,1695,1196,8879
u,u,1887,255,6276,723,45,205,175,1148
m,u,1806,77,1355,1173,125,393,1100,2791
u,f,1931,2932,59286,18001,1449,4072,3875,27397
u,m,1876,2227,81675,8853,801,2595,1535,13784
f,u,1801,11,583,170,24,55,186,435
m,m,1911,15415,2380954,432707,31105,100537,224168,788517
f,f,1840,750,192767,27277,2305,8669,23641,61892
m,u,1898,852,98864,17949,1563,4468,10735,34715
f,m,1842,647,153841,24477,1813,7378,19776,53444
u,u,1899,825,29094,3670,262,799,691,5422
m,f,1800,245,18337,4947,503,1450,3370,10270
f,u,1989,12363,759939,383453,27330,70518,218485,699786
u,u,2006,17262,308185,106532,7314,20861,25261,159968
f,m,1863,717,110691,18946,1873,5432,14877,41128
u,f,1873,1121,29042,3643,402,1040,833,5918
f,f,2005,8065,816355,400597,26355,65939,216191,709082
f,m,1990,9810,948388,348743,22828,61252,177397,610220
f,f,1873,1755,442768,76078,6890,18184,55570,156722
u,u,1964,15858,297533,84082,5718,17645,16768,124213
f,f,1957,3458,440822,167358,12198,29612,81908,291076
f,m,1803,124,4626,1517,172,625,1850,4164
u,f,1984,5099,132009,34897,2208,6365,8523,51993
u,m,1992,11367,136973,47522,3391,9913,10424,71250
m,f,1851,1471,172641,28880,2877,8590,21479,61826
f,u,1990,13877,941081,433070,31736,78806,245565,789177
f,u,1924,4098,457292,152632,12259,32024,93644,290559
u,m,1831,1839,72227,4320,333,1394,1036,7083
m,m,1918,13546,1703548,370462,27161,78750,184088,660461
m,m,1906,11505,1605499,306503,22049,67959,161668,558179
u,u,1955,13470,355690,76640,5247,16642,15635,114164
f,u,1857,448,79470,14108,1153,3803,11740,30804
m,m,2005,23526,1401545,702459,45659,121326,321895,1191339
u,u,1844,126,2271,432,39,178,88,737
f,f,1864,1373,359293,59991,5124,15025,45214,125354
f,f,1936,4195,625891,216817,16822,40218,122662,396519
u,m,1803,147,2368,286,26,109,62,483
m,m,2009,14018,736612,453559,28375,75832,198561,756327
m,m,1809,346,21085,4916,372,1616,3521,10425
f,m,1848,806,135904,18926,1487,5702,16551,42666
m,u,1996,28619,1543052,626256,46335,125038,316349,1113978
f,u,1909,562,106488,21326,1619,4687,13641,41273
m,f,1843,897,125070,18763,1446,5659,15325,41193
m,f,1940,5633,509695,167380,11896,31953,72760,283989
f,u,1817,75,9578,2241,186,1049,1892,5368
m,m,1894,13410,1790180,314289,24019,76564,174944,589816
u,m,2012,0,0,0,0,0,0,0
m,m,1800,148,29705,4550,341,1418,3135,9444
u,u,1853,226,7686,805,56,268,122,1251
m,f,1872,2825,384462,65152,6173,16549,39745,127619
f,f,2009,3667,196605,189112,12809,31440,105190,338551
u,u,1867,327,7680,689,62,240,165,1156
f,u,1876,322,68523,11456,1016,3060,8863,24395
f,f,1859,915,169490,28534,2507,7417,24749,63207
m,m,1877,4489,711421,100432,8707,26505,64443,200087
m,m,1930,17893,1768305,544314,40147,108132,276191,968784
u,m,1999,12060,217769,62349,4089,11900,13723,92061
m,f,1941,6752,718047,228741,15885,42362,106381,393369
u,f,1928,2386,52875,12030,949,2973,2640,18592
m,f,1865,2944,408515,70513,6496,18098,43003,138110
m,f,1904,4504,477796,97928,7163,22137,55426,182654
m,u,1877,419,46866,8454,737,1927,5358,16476
u,m,1819,442,15021,862,73,281,309,1525
u,m,1905,4679,136092,18304,1287,4828,3547,27966
f,m,1968,8442,676451,278154,20720,51827,142894,493595
u,m,1958,10090,188617,54216,4184,11219,10518,80137
f,f,1899,3935,881501,154890,12821,33961,103969,305641
f,f,1800,184,32416,6557,678,2156,6144,15535
m,u,2009,7049,239746,162329,12030,31288,82687,288334
f,m,1934,5266,579816,197861,16355,40003,109623,363842
m,f,1882,4058,530137,102289,8603,24798,55792,191482
m,f,1933,5086,475986,164572,12798,32702,79266,289338
u,f,1894,2457,75335,8721,759,2523,2483,14486
f,f,1850,806,264594,39052,3374,10915,31702,85043
m,m,1986,24790,1954032,746232,47269,124853,329157,1247511
u,f,1851,582,13113,1361,132,536,481,2510
m,m,1826,1942,345521,38874,2767,11286,31942,84869
u,u,1818,54,311,79,7,30,18,134
f,u,1976,10180,856104,329126,25250,64415,187843,606634
u,u,1922,4410,71855,19793,1617,5235,4613,31258
u,m,1815,232,2948,223,34,88,67,412
f,u,1934,3739,355602,137946,11422,27362,79190,255920
m,f,1822,617,102815,20596,1639,5962,15757,43954
m,f,1885,3453,522198,97702,8903,24040,53784,184429
f,m,1960,6048,517013,202715,15376,37760,101731,357582
u,u,1984,17639,356868,91611,5901,21404,18261,137177
u,m,1885,4334,124194,14343,1149,4122,2946,22560
m,m,2011,85,6866,2098,62,266,1015,3441
f,m,1908,3873,602028,133972,10559,30866,83208,258605
f,f,2002,7549,685288,352453,23209,56579,186381,618622
u,f,1995,6852,104367,34525,2414,7316,8674,52929
f,u,1867,294,57774,10382,786,2413,7245,20826
m,u,1959,18408,1294082,452026,32689,92305,233323,810343
u,m,1966,14208,246070,74197,4583,14059,14680,107519
f,f,1858,966,290064,46213,3952,12236,35726,98127
f,m,1915,4076,730829,160883,12610,34264,92279,300036
u,m,1945,7565,135725,35353,2474,7423,6065,51315
u,m,1920,7104,183430,29797,2234,7521,6284,45836
f,m,1828,455,67348,8161,740,2760,8440,20101
f,f,2010,102,5874,1472,115,337,808,2732
f,u,1839,251,47325,5893,501,1869,5334,13597
m,m,1976,23996,1851306,706403,44550,118774,320985,1190712
m,m,1907,12293,1608849,324143,23647,74073,171939,593802
m,m,1994,22572,1438551,638163,42117,109016,285132,1074428
m,f,1866,2553,420225,66912,6315,17197,42525,132949
m,u,2001,21466,1184865,506443,35731,94242,260783,897199
f,m,1995,7694,684710,290075,18412,49039,152290,509816
u,u,1931,11305,229732,53669,3526,12448,11876,81519
m,u,1939,10047,911355,283574,19082,53033,139973,495662
f,f,1901,2897,531241,103000,8749,21373,65833,198955
f,f,1871,1422,360684,58635,5341,14145,43035,121156
u,u,1900,916,24781,3577,268,1137,838,5820
u,m,1887,4453,137734,17029,1458,4464,3559,26510
u,f,1845,1296,42577,3082,285,1255,857,5479
f,m,1926,4539,576555,178730,14245,35730,102533,331238
f,u,1988,11037,773959,346456,26358,65891,200622,639327
u,m,1828,695,24116,1794,156,630,476,3056
f,f,1865,1841,521079,88989,8177,22022,65761,184949
f,u,1940,3230,400196,139550,9916,25217,71178,245861
m,u,1995,25811,1303446,566922,40260,111577,292815,1011574
u,m,1909,5580,140729,20400,1600,5454,4724,32178
m,u,1830,1415,237543,24984,2187,8284,20414,55869
m,u,1941,10172,875130,294576,20616,59493,149766,524451
u,f,1825,147,2856,381,38,147,84,650
m,f,1850,1291,213168,30835,2540,8326,21782,63483
u,f,1966,3421,65417,20769,1404,4140,4539,30852
u,m,1805,106,2667,510,45,203,120,878
u,f,1916,2815,79404,12553,1036,3203,2824,19616
f,u,1852,213,47172,6725,540,2016,5029,14310
m,f,1826,612,79425,12186,969,3702,10300,27157
u,m,2002,12515,169289,59803,3896,11082,11885,86666
m,u,1901,2785,368840,65581,5286,16006,35728,122601
u,m,1833,1090,45818,3467,277,1012,757,5513
f,m,2013,3,0,18,3,2,9,32
u,f,1820,266,9505,1686,117,602,344,2749
f,u,1898,350,53189,10682,922,2584,7852,22040
f,m,1830,633,108653,13445,1129,4642,14155,33371
m,m,1952,19143,1782071,643680,44197,111642,283445,1082964
f,f,1967,3550,353002,154703,10781,26147,76614,268245
f,f,1915,4381,1034485,203301,14831,41118,124784,384034
m,u,1800,15,602,110,6,44,104,264
u,f,1999,7324,100685,38293,2720,7704,9335,58052
m,u,1829,125,24355,4193,397,1288,2785,8663
m,u,1831,303,26813,4925,469,1536,4102,11032
u,f,1840,518,18335,1699,156,533,411,2799
u,m,1867,1375,37858,4383,413,1316,926,7038
m,u,1942,10959,968984,319361,22431,57896,148667,548355
f,m,1993,7476,492767,244835,16758,43343,124175,429111
m,u,1943,12605,946430,345284,24318,61933,159610,591145
f,m,1805,30,590,296,42,119,289,746
u,u,1999,17390,313030,99873,6635,20378,24563,151449
f,m,1861,529,95783,14641,1386,4190,11010,31227
u,u,1988,18974,330740,102785,7078,20742,22290,152895
m,f,1855,2170,318550,48625,3782,12893,31411,96711
m,f,1824,749,163675,23987,1964,7334,17090,50375
u,f,1855,820,31031,2156,188,684,386,3414
u,u,1925,8342,201413,40339,3014,10674,8157,62184
f,u,1824,79,12647,3542,324,1293,3192,8351
u,f,1839,496,14660,1716,127,621,452,2916
m,f,1988,15629,1425853,487467,33439,88004,225657,834567
f,u,1965,8289,628406,260879,20922,53186,147037,482024
m,u,2010,1210,52330,23369,1864,5104,12788,43125
f,f,1828,282,66833,10507,862,3448,9627,24444
u,f,1853,507,20832,1639,172,558,340,2709
m,m,1838,1608,198185,26978,2154,8227,20537,57896
u,m,1910,6363,152404,22794,1744,6252,5385,36175
f,u,1906,577,79926,18629,1421,4407,11689,36146
f,f,1996,8424,873598,403745,26110,65157,210798,705810
m,u,1993,31377,1407827,743915,54621,141342,374508,1314386
u,u,2012,0,0,0,0,0,0,0
u,m,1937,8799,137295,33439,2611,7748,7137,50935
m,m,1868,3216,482537,84331,7035,22723,49164,163253
f,u,1948,6509,579356,236546,19718,48301,135917,440482
u,f,1800,93,2184,266,32,108,52,458
f,u,1984,9039,653072,316536,23376,58359,179727,577998
u,u,1930,12165,322470,69853,4893,15590,14682,105018
u,f,1991,6164,112912,37659,2763,7409,8571,56402
m,f,1828,454,101560,12816,1062,4138,9634,27650
f,u,1844,135,22813,4484,294,1334,4267,10379
u,u,1885,351,9495,1110,132,329,318,1889
u,f,1990,7665,223592,56723,3740,10169,13798,84430
m,f,1935,6652,527516,187576,14772,37409,91999,331756
f,m,1907,3618,608606,114440,8662,25359,70130,218591
u,m,1989,16594,317968,84184,5299,15738,17193,122414
f,f,1813,410,69483,11315,803,4020,14119,30257
u,u,1905,950,40183,4718,346,1195,1024,7283
m,u,1903,2530,333955,60651,4658,14532,34019,113860
u,f,1842,551,16665,2139,180,771,387,3477
f,u,1941,3925,494057,155005,11249,27147,86397,279798
m,f,1963,6469,597429,224192,15650,40587,96475,376904
f,f,1803,123,22452,3282,232,1277,3730,8521
m,u,1881,715,71294,14500,1346,3923,8735,28504
m,u,1807,99,8514,2105,205,700,1736,4746
f,m,1873,1075,210643,34011,3059,9367,25346,71783
m,u,1863,530,79541,12179,1110,3017,7774,24080
u,f,1814,364,3913,1305,93,483,315,2196
f,u,1854,362,78115,12317,1024,3224,9126,25691
f,u,1929,6466,793903,245111,18704,53994,155676,473485
f,m,1973,7109,487051,202935,14822,37814,103675,359246
m,m,1939,13248,1288591,407174,27770,73606,185628,694178
u,u,1921,1196,27816,5143,399,1231,1066,7839
m,f,1967,6605,500064,203748,14845,36752,87152,342497
m,f,1818,610,69041,13633,1303,4307,10668,29911
f,m,1965,7110,553434,214962,15024,38969,107525,376480
f,m,1850,1481,410464,53699,4105,16421,45710,119935
u,u,1875,203,2653,576,55,191,132,954
m,m,1919,13676,2074411,447783,32079,94527,221565,795954
f,m,1829,1055,190818,19902,1546,5811,19876,47135
m,u,1949,15615,1081191,419270,30230,82761,206517,738778
m,f,1879,2117,287902,59879,5535,14040,34281,113735
f,f,1927,2325,353757,123478,9479,23456,70589,227002
m,u,1926,13189,977972,322742,25487,73483,180876,602588
u,f,1830,314,14831,929,102,364,252,1647
m,f,1931,5459,556150,192881,15416,38382,93598,340277
u,f,1876,1281,51878,5858,586,1556,1736,9736
u,u,1806,55,299,189,24,109,48,370
m,m,1891,9245,1069290,202661,17820,48612,116316,385409
f,u,1972,7935,716045,274834,21001,55131,162227,513193
f,u,1930,6188,715758,238849,18447,50032,137964,445292
f,f,1870,1414,363047,65478,5804,15930,47835,135047
f,u,1816,129,15685,2150,254,781,2071,5256
m,m,1817,277,25433,4816,356,1362,3128,9662
m,m,1978,27104,2267743,855715,54290,140607,369857,1420469
u,f,1962,3564,58563,19574,1329,4206,3649,28758
m,u,1853,587,69493,11109,984,3218,7505,22816
m,m,2001,24093,1277275,626395,40543,107903,290191,1065032
f,m,1936,4369,518349,176161,13227,33025,95428,317841
u,m,1971,13004,193453,56547,3968,11401,11295,83211
m,m,1987,27293,2306557,893578,56281,147808,388207,1485874
m,m,1902,9822,1165804,222168,16809,54660,122718,416355
f,f,1821,309,101803,19079,1472,5123,17638,43312
m,m,1974,24278,1675382,677065,44659,116373,307959,1146056
u,u,1913,1417,35250,5872,463,1482,1175,8992
u,u,1872,343,7488,873,79,288,253,1493
m,f,1997,16613,1051553,469060,32491,84915,223204,809670
f,m,1984,8073,741983,287081,19803,50770,144406,502060
m,u,1952,16923,1555695,523330,39781,107149,267198,937458
f,f,1825,287,101243,13250,955,4120,10201,28526
m,m,1831,3727,560581,56166,4265,16038,46054,122523
m,m,1816,368,26379,4959,461,1593,4470,11483
f,f,1907,3039,669300,133581,10135,26501,81133,251350
u,u,1909,951,32869,4444,346,1113,778,6681
f,m,1841,673,130045,15689,1300,5856,13469,36314
f,u,1891,452,71989,13686,1294,3538,10198,28716
m,m,1943,15654,1474140,481486,32832,80101,202149,796568
m,f,2014,0,0,0,0,0,0,0
m,u,1885,605,57692,10177,970,2688,6229,20064
f,f,1835,1695,320639,50629,4867,14156,44586,114238
m,m,1837,2255,411025,50456,4033,14820,37612,106921
u,u,1805,10,18,23,3,6,1,33
m,f,1894,5638,769777,139240,12159,33477,80649,265525
f,m,1999,6932,515408,268176,17722,45484,140677,472059
u,m,1810,342,6050,785,82,264,219,1350
f,u,1987,9356,605770,288507,22548,54713,161493,527261
m,u,1861,457,45330,7130,644,2138,5336,15248
f,m,1852,1468,284967,35824,3245,11138,29212,79419
u,m,1934,9951,295055,47413,3303,10969,10274,71959
f,m,1813,68,3138,394,36,182,422,1034
u,u,1951,10252,217446,56206,3849,11937,11294,83286
m,f,1846,907,121250,20590,1844,5540,15091,43065
f,u,1841,63,6884,1557,116,443,1310,3426
u,m,1968,15203,233831,74923,4809,15020,15036,109788
f,u,2013,0,0,0,0,0,0,0
m,f,1922,8467,1024500,243842,19530,52402,121893,437667
u,m,1897,6212,190616,23643,1875,6737,5132,37387
m,f,1932,4483,439154,157771,12102,31207,80530,281610
u,m,1856,1501,55702,4579,413,1469,963,7424
u,f,1884,2065,53072,7100,696,2082,1775,11653
f,f,1881,2319,492093,93969,8361,22346,66354,191030
m,m,2007,23452,1380695,721694,46318,119582,323958,1211552
u,m,1849,1310,35927,4003,306,1422,778,6509
u,f,1877,1417,54105,6935,560,1866,1929,11290
u,m,1930,9298,171852,40829,2976,9618,8562,61985
f,u,1858,726,118661,21198,1938,4941,15906,43983
u,f,1988,8847,250316,67621,4185,11912,15356,99074
f,m,1902,3040,545171,99256,7491,23828,64077,194652
f,m,1996,7583,539619,244633,16024,41857,131282,433796
u,m,1925,7571,152502,34430,2578,7845,7629,52482
u,u,1904,1016,29970,4208,342,1167,847,6564
m,m,2010,380,8040,7744,527,1303,2957,12531
f,m,1897,3671,683780,123880,9838,30032,80666,244416
u,m,1878,2810,55290,7936,750,2298,1790,12774
u,f,1968,3740,62714,19660,1366,4055,4152,29233
m,m,1982,24999,2365096,829944,51632,137626,362723,1381925
m,m,1859,5095,698524,89332,7692,24694,64385,186103
u,m,1994,11832,189671,58779,4068,11838,13003,87688
f,f,1833,722,159141,24457,2112,7429,21706,55704
f,u,2004,8776,489481,267766,19657,50091,163046,500560
m,u,1947,19187,1698040,595636,44083,109944,289296,1038959
f,m,1819,203,38757,3815,342,1110,3684,8951
f,f,1997,8810,843123,387500,25119,64877,214099,691595
m,f,1873,2618,398762,71384,6505,17729,40349,135967
m,f,1962,6480,614074,222196,15375,38711,95032,371314
f,u,1903,1059,181973,32781,2586,7372,21417,64156
f,f,1993,6494,564093,294463,19547,48473,157150,519633
m,f,1825,433,74095,11351,919,3236,7577,23083
f,f,1819,178,18458,3096,320,1056,3146,7618
f,u,1875,134,23137,4914,497,1182,3587,10180
m,f,1977,7216,542766,203979,15289,38326,90332,347926
u,m,1875,1484,52271,5637,526,1669,1276,9108
u,f,1924,1536,25209,6594,495,1570,1609,10268
f,m,1958,5845,567808,216365,15645,40435,105983,378428
u,f,1901,2779,67823,10394,788,2716,2342,16240
f,f,1860,1497,305929,52524,4628,13386,40342,110880
m,f,1844,1302,194790,28761,2371,8589,20942,60663
f,u,1911,858,126899,23476,1958,5589,15251,46274
m,u,1809,51,2053,843,83,296,672,1894
u,f,1841,766,26869,1979,194,748,518,3439
m,u,1963,21619,1418901,577408,41788,113666,293573,1026435
u,f,1892,2304,75919,9353,878,2790,2389,15410
f,m,1916,4159,777976,169701,13066,36674,95176,314617
m,u,1920,2818,366751,79835,6280,16712,41642,144469
u,u,1878,284,9990,914,91,235,229,1469
f,m,1880,2493,463707,69812,6096,17828,49185,142921
m,u,1935,12611,1117361,367739,27972,70245,189440,655396
u,f,1804,97,5046,317,28,132,33,510
m,u,1860,1071,150923,23339,2057,6267,16576,48239
f,m,1820,183,15485,3313,277,1040,3078,7708
m,u,2014,0,0,0,0,0,0,0
u,u,1940,6765,168654,44427,2966,9772,8368,65533
u,m,1883,5597,123198,13191,1209,4124,3145,21669
f,f,1932,2327,338139,142496,10323,25668,79453,257940
u,m,1902,4813,119726,17722,1440,4809,3609,27580
u,m,1953,9657,208975,51724,3515,10590,9787,75616
m,u,1821,234,25095,5743,422,1767,5360,13292
f,u,1885,205,21041,3367,381,883,2606,7237
m,u,1961,23388,1864360,692241,49199,134983,360140,1236563
m,f,1870,2237,312911,60346,5525,15037,35000,115908
m,f,2006,14443,909560,478410,33306,86197,219588,817501
u,m,1845,1112,41141,3532,283,1128,608,5551
m,m,1975,21531,1769569,681659,43069,117051,306119,1147898
u,m,2014,0,0,0,0,0,0,0
m,f,1984,10061,835601,305578,21192,55903,139940,522613
u,m,1917,5736,142244,24661,1996,6425,5401,38483
u,u,1827,202,4686,503,45,215,113,876
f,u,1917,714,120821,24222,2179,5730,17129,49260
m,f,1903,4415,469609,103660,8316,23261,56326,191563
u,m,1864,1673,47538,4289,476,1504,1256,7525
f,f,1809,295,57536,9582,919,3274,8879,22654
m,f,1952,7553,660402,248229,18071,44893,113651,424844
f,m,1887,2600,438642,82999,7685,19896,56384,166964
m,u,1991,32912,1465051,721609,52777,138427,365935,1278748
u,u,1954,10761,290059,74972,4562,14736,14413,108683
u,m,1926,8924,247025,35002,2686,8448,7777,53913
m,f,1943,6604,666181,215833,15779,40219,95527,367358
f,m,1845,751,121622,17880,1460,5371,15215,39926
f,m,2014,0,0,0,0,0,0,0
m,f,1980,10483,801139,322730,23232,59130,146684,551776
u,m,1913,6674,179210,26464,2037,7267,5686,41454
m,m,1804,470,32269,6224,575,2166,5061,14026
m,m,1941,12666,1264819,405601,26972,71605,185472,689650
f,f,1964,3238,346869,146423,10715,24460,68418,250016
m,u,1818,126,9905,1826,179,609,1880,4494
f,u,1918,589,91659,19327,1466,4623,11481,36897
u,f,1881,1809,51759,6876,608,1984,1628,11096
m,f,1970,9209,637909,245829,18192,45663,104318,414002
u,f,1908,2780,78350,10936,828,2636,2364,16764
u,u,1856,196,6135,321,30,125,84,560
f,m,1814,8,0,37,3,7,47,94
u,u,1849,151,2664,260,16,78,53,407
m,m,1883,11728,1350313,236296,21134,60809,148125,466364
f,u,1874,173,29973,4754,411,1344,3960,10469
m,u,1866,319,34734,6165,659,1653,3725,12202
m,m,1914,14311,2139816,422806,31089,91643,211506,757044
u,u,1990,23535,450319,128827,9266,26225,28494,192812
f,m,1945,4610,434370,164165,12443,29819,80071,286498
u,f,1976,3763,84629,25393,1681,4875,5397,37346
m,u,1848,317,38865,5311,452,1619,4203,11585
f,u,2011,4,0,0,0,0,1,1
u,u,1969,21549,362531,100940,7520,22006,21008,151474
f,f,1942,2817,496318,155711,11570,27544,80705,275530
m,m,1924,14592,1395860,449319,32911,89472,228759,800461
u,u,1948,11101,233973,54794,3932,12571,10433,81730
u,u,1810,111,711,155,17,72,54,298
m,f,1928,4407,374728,135914,10639,27501,65693,239747
m,m,1903,10626,1313336,257693,19942,61353,139838,478826
u,m,1890,5596,187467,19931,1731,5888,4493,32043
f,u,1949,5235,469148,186060,13697,33910,98144,331811
u,f,1910,3069,92790,13306,1110,3482,3321,21219
f,m,1937,5672,616800,220377,16808,40399,110307,387891
u,u,1850,54,5146,371,14,117,45,547
u,u,2004,17416,286917,96104,7060,20448,23168,146780
u,u,1897,393,19924,1606,129,323,364,2422
m,u,1970,35163,2021319,776066,59988,162247,412450,1410751
m,u,1945,13988,1147656,388387,28135,68841,183342,668705
f,f,1970,4228,465466,182939,13127,31348,85067,312481
u,f,1915,3291,79787,13710,1105,3660,3219,21694
f,u,1893,437,64492,13171,1195,2901,9681,26948
f,m,1878,1984,240398,47630,4382,12418,35313,99743
m,u,1900,2091,219207,40685,3112,9870,22989,76656
u,u,1817,55,960,158,25,72,52,307
m,m,1872,7274,1085928,140704,11567,38796,84872,275939
f,f,1903,2515,492192,99870,7567,21008,64115,192560
f,f,1947,4040,556517,197562,14377,33096,98595,343630
m,f,1989,14931,1328836,484903,32798,86670,219806,824177
f,f,1823,291,74471,13114,1180,4501,11177,29972
m,m,1989,31287,2496243,965362,60605,161145,425812,1612924
m,u,1835,404,45880,5552,391,1713,4744,12400
f,u,1849,163,14220,2885,271,843,2454,6453
m,m,1937,18173,1626865,550357,40038,101827,256079,948301
m,m,1966,24303,1943097,759313,48584,127198,324941,1260036
f,f,1919,4063,866319,180019,13989,36057,108193,338258
f,m,1853,1511,128793,18345,1709,5689,14584,40327
m,u,1859,543,38893,9331,821,2387,5862,18401
f,u,1815,219,29581,5144,493,1525,4194,11356
u,f,1950,3387,63592,18496,1460,3874,3771,27601
u,u,1960,15366,365575,89149,5569,18565,18053,131336
u,u,1974,13178,254276,66537,4672,14233,13289,98731
f,u,1826,56,7596,1402,81,540,1330,3353
u,f,2002,6673,100025,35302,2433,7022,8112,52869
m,m,1947,23419,2140728,701058,49478,122800,320557,1193893
f,f,1862,864,183082,29364,2781,7797,23266,63208
u,f,1836,384,9188,1304,119,484,307,2214
u,u,1972,14579,241863,67548,4946,14538,14573,101605
m,m,1825,2726,373251,45717,3560,13824,37298,100399
f,u,1810,69,4563,1026,83,348,1123,2580
u,m,1860,1554,58307,4945,351,1585,1056,7937
f,u,1975,9115,732065,308885,24368,64431,182058,579742
u,f,1871,1040,35722,3833,363,1068,868,6132
m,f,1961,6740,528172,205845,15221,36678,92797,350541
m,m,1961,22688,1993511,718921,47526,121525,310306,1198278
f,u,1819,96,9259,2868,211,995,2482,6556
u,u,1934,6338,158782,34408,2658,8809,7356,53231
u,u,1808,36,347,76,11,23,20,130
u,u,1845,270,9368,941,70,292,149,1452
m,u,1975,25062,1500831,595970,44991,120031,300343,1061335
u,u,1917,1314,54194,6744,516,1646,1283,10189
u,u,2003,14832,295832,88866,6088,17596,19875,132425
u,f,1949,3099,63225,16821,1265,3483,3204,24773
f,u,1888,422,63170,10222,871,2385,7810,21288
m,u,1840,309,26614,4279,349,1384,3825,9837
m,m,1963,20900,1454739,598151,40773,103202,262570,1004696
u,m,1927,9641,198653,37589,2913,9854,8484,58840
u,f,2008,7009,93002,44142,3147,9082,10525,66896
u,m,1965,13872,265062,72460,4570,14369,13699,105098
f,u,1942,3339,367746,133108,9877,24844,71496,239325
m,m,1935,18367,1682064,568007,41672,106411,275697,991787
f,f,2003,7333,726714,384058,25749,63386,210678,683871
f,u,1835,123,22331,2497,198,782,1965,5442
u,f,1900,2799,76225,10479,917,2762,2490,16648
f,u,1957,6963,743759,286456,22378,55783,153850,518467
m,f,1821,398,61076,13952,1002,4144,12422,31520
u,m,1823,1000,24759,2298,204,843,511,3856
u,m,1836,1175,41697,3303,288,1123,682,5396
u,u,1953,11882,271086,65482,4391,14329,13508,97710
m,m,1964,22843,1978884,725642,47753,122044,317971,1213410
m,u,1977,27412,1607005,663355,47818,127527,326312,1165012
m,f,1939,4997,481928,164689,11773,30886,75605,282953
m,f,1951,7275,643500,226363,16649,41226,101445,385683
m,f,1896,7359,935361,158078,13619,38313,92196,302206
f,f,1802,149,23211,4420,468,1715,4354,10957
f,m,1810,236,7992,6343,711,2261,5775,15090
m,f,1947,7805,762564,252084,18218,44460,110978,425740
u,f,1997,8672,139731,40874,2615,7522,10092,61103
m,f,1861,1227,105020,20409,2001,5471,13219,41100
u,f,2001,6656,141043,40569,2638,8048,9702,60957
u,u,1906,825,15102,2581,236,767,619,4203
u,f,1843,508,18598,1661,133,580,360,2734
f,u,1831,105,13257,1972,253,575,1932,4732
f,f,1883,2708,541068,111203,10587,25344,79845,226979
u,f,1807,237,2665,734,42,343,133,1252
u,m,1990,17352,354252,94219,5466,16913,19804,136402
f,u,1808,139,17309,2072,216,822,1485,4595
f,m,1849,764,89155,14930,1487,4641,12337,33395
m,m,1889,8461,991808,168200,14189,41200,99300,322889
u,f,1822,228,5700,833,77,301,272,1483
f,u,1964,6706,593830,237127,18004,46733,134837,436701
u,f,1883,2208,57139,7691,779,2293,2017,12780
f,m,1914,4815,1008726,201803,15348,43123,116730,377004
m,f,1914,6163,804992,172867,12917,37784,90599,314167
f,u,1836,111,7886,1541,186,481,1523,3731
u,m,1996,12458,181757,58349,3786,11507,13695,87337
f,f,1985,6606,812697,347414,23405,57731,184411,612961
f,m,1969,8828,652523,272622,19526,49368,139965,481481
f,m,1888,2915,567775,99846,8242,25075,71653,204816
m,m,1929,18053,1594273,529715,38642,107510,262753,938620
u,u,1941,6666,111150,29852,2149,7601,7102,46704
f,m,1837,621,102907,14016,1234,4446,12844,32540
u,u,1894,368,6101,1144,142,393,233,1912
u,f,1930,2602,46127,16097,1263,3760,3554,24674
m,u,1892,1147,98539,18334,1514,4766,11164,35778
u,m,2007,12138,197958,66363,4113,12992,13312,96780
u,f,1823,276,9522,1035,86,312,190,1623
f,f,1926,2250,289181,108700,8159,21603,65891,204353
m,m,1886,6811,873288,158509,13369,38929,92971,303778
m,m,2013,21,2072,1008,132,354,448,1942
f,m,1920,5068,839883,200110,16263,41817,113189,371379
m,u,1999,24308,1268885,590290,40461,110915,299224,1040890
u,m,1942,7611,126245,36780,2480,7816,7053,54129
u,m,1969,15127,257179,66071,4628,13452,12521,96672
f,u,1954,5155,564613,200238,14578,36999,108521,360336
f,u,1863,326,69882,11286,1057,2767,8797,23907
u,m,1948,8718,203837,44815,3039,9039,9268,66161
u,u,1956,12330,311205,72147,4782,15451,14863,107243
f,m,2012,0,0,0,0,0,0,0
u,u,1839,184,5544,474,40,214,100,828
u,f,1835,977,18619,1928,194,626,539,3287
f,f,1904,2327,460938,82729,6033,17916,54549,161227
u,u,1965,18426,319078,95665,6512,20637,19354,142168
m,f,2000,13668,826668,430044,31148,78217,194950,734359
u,u,1826,97,9532,489,49,135,160,833
u,m,1869,2064,46328,4980,489,1494,1172,8135
u,m,1832,881,45011,3218,236,1071,777,5302
f,f,1880,2295,453786,106703,9486,25557,78503,220249
m,m,1922,20358,2387641,580615,42592,119881,288444,1031532
m,m,1970,28215,2064422,810135,52841,137397,349727,1350100
m,m,1821,760,83974,13234,997,3696,10449,28376
f,f,1815,315,95989,13410,1093,4171,11865,30539
m,m,1806,303,32940,4928,436,1537,4265,11166
f,f,1945,3541,528314,177834,12667,30499,92878,313878
u,f,1992,6593,142458,45427,2732,8357,11086,67602
u,f,1942,2824,56270,14092,1143,3375,3245,21855
m,f,1919,6481,910855,203913,15881,43483,101333,364610
u,u,2011,65,485,63,2,16,3,84
f,f,1807,206,27869,8288,523,3132,9283,21226
u,u,1843,199,11347,1072,86,404,230,1792
m,u,1834,520,61846,7746,596,2217,6286,16845
f,f,1847,628,175459,29853,2673,8686,26373,67585
f,m,1953,5760,621812,223271,15404,39939,108516,387130
m,m,1880,7089,1047165,162901,13169,43193,102653,321916
f,m,1899,5722,888276,160339,13018,38659,108587,320603
m,u,1966,22474,1718131,586952,43013,112617,297626,1040208
u,f,1882,2164,78084,9902,809,2794,2388,15893
m,m,1840,3646,499887,69976,5408,20886,49672,145942
f,u,1846,190,39354,4422,439,1604,4237,10702
f,m,1860,1039,165364,26791,2399,7885,23196,60271
f,f,1975,4012,411102,170073,12683,30258,86239,299253
m,m,1913,15497,2410314,467225,32522,102506,229258,831511
f,u,1905,812,111444,21127,1704,5499,14211,42541
f,f,2014,0,0,0,0,0,0,0
u,f,1989,7886,282842,62502,3744,11111,15273,92630
u,f,1953,3037,53556,15207,1141,3367,3577,23292
u,u,1895,700,16179,2567,224,786,614,4191
f,u,1827,176,29042,3958,439,1204,2884,8485
m,f,1840,1140,186845,27086,2349,8764,21150,59349
f,m,1802,11,477,213,23,110,332,678
m,m,1980,26434,2208631,793768,50067,133686,344256,1321777
u,m,1804,362,9317,737,89,291,134,1251
m,f,1929,5326,471335,161518,12710,33304,84574,292106
m,m,1977,22115,1752522,694072,43468,113961,308627,1160128
m,m,1824,1482,131257,22825,1820,7199,18506,50350
f,u,1919,811,122905,28484,2522,6236,18185,55427
m,u,1967,32170,2067349,792252,58922,163937,409377,1424488
f,m,1896,5408,687361,131160,11369,32406,86278,261213
f,f,2001,7350,776985,376995,24128,60365,198535,660023
m,u,1820,141,18077,2703,229,756,2037,5725
m,u,1862,533,78166,13178,1381,3483,8174,26216
f,u,1947,6765,789975,272479,20992,49575,148339,491385
u,m,1995,12767,231890,70465,4455,13160,14966,103046
u,f,1987,6814,190645,46383,2777,8322,11009,68491
u,u,1973,14783,262950,78411,5651,16703,16756,117521
f,u,1828,172,29670,4359,343,1143,2738,8583
u,f,1878,1526,44368,5360,529,1590,1543,9022
u,u,1848,169,9762,542,44,250,116,952
u,f,1920,3305,66378,12140,1052,3208,3069,19469
f,f,1824,433,133540,20672,1738,6460,17848,46718
u,f,1980,5860,131883,37956,2650,7236,8735,56577
f,m,1977,6470,532151,222497,15398,38872,111315,388082
m,f,2005,14731,938279,456691,31874,82287,211353,782205
u,u,1836,68,4239,431,38,178,73,720
m,u,2002,22664,1256862,527187,37262,98080,265946,928475
f,u,1979,9183,752972,297208,23182,58684,171640,550714
u,f,1974,4112,81460,25233,1694,4559,5907,37393
u,f,1994,7148,161040,52229,3109,8955,12550,76843
f,f,1874,1468,336770,62479,5724,15688,43126,127017
f,m,1909,3921,674872,131965,10287,30205,79728,252185
u,u,1992,22967,476995,132267,9689,27680,30282,199918
f,u,1802,53,7833,1100,81,394,1224,2799
u,m,1868,1638,43538,5348,486,1733,1115,8682
f,m,1890,3302,612107,108385,9554,27024,75039,220002
u,u,1888,413,10913,1457,158,424,422,2461
m,f,1808,96,11323,1301,130,486,1420,3337
f,f,1841,1075,176169,31855,3001,10462,28920,74238
m,f,1881,3758,423858,93135,8191,23466,52246,177038
m,u,1886,1028,103534,19542,1825,5183,12916,39466
u,f,1819,164,1145,599,74,241,122,1036
m,u,2013,0,0,0,0,0,0,0
f,f,1817,368,95189,13103,1092,4201,13980,32376
u,u,1866,111,2101,261,25,99,72,457
m,m,1999,22457,1470937,657325,40854,113152,299941,1111272
f,m,1979,7196,683522,257871,17690,45042,132741,453344
m,m,1988,30421,2480468,917621,57275,154201,414782,1543879
m,f,1945,6758,770152,231655,16451,40439,98701,387246
m,m,1814,21,205,149,9,37,85,280
f,m,1833,633,89077,10962,976,3607,10308,25853
u,u,1852,197,4564,584,41,164,64,853
u,u,1835,121,3315,263,29,102,100,494
m,f,1975,8003,520659,207109,15831,39785,90606,353331
f,u,1956,6772,693826,256194,20018,51325,141815,469352
u,u,1893,468,7527,1279,140,396,329,2144
u,m,2010,147,292,593,38,75,73,779
f,u,1953,6435,522626,192217,13992,36073,103008,345290
u,f,1870,987,29618,3188,295,941,901,5325
f,m,1943,4224,445196,149006,10777,27270,71555,258608
u,f,1905,1975,55307,7751,588,1917,1790,12046
f,u,1868,558,125450,24110,1848,5977,16909,48844
u,f,1826,351,18769,1509,126,462,522,2619
f,f,1929,2856,386040,139133,10883,26062,80739,256817
u,m,1993,12355,136905,50034,3704,10550,11656,75944
m,m,1851,2326,359641,52152,3809,16376,32794,105131
f,u,1986,10405,755977,342766,24672,65228,195826,628492
m,f,1806,201,23549,5789,385,1862,4929,12965
u,f,1867,1458,37555,3805,376,1208,901,6290
m,m,1933,15033,1563299,478226,33676,91045,228278,831225
u,f,1868,1004,30900,3100,314,957,746,5117
u,m,1929,9883,167522,40707,2970,10119,7935,61731
m,f,1805,75,9695,2420,161,759,2077,5417
u,f,1932,2166,38528,10617,867,2530,2966,16980
f,m,2010,134,6187,5674,387,826,2493,9380
u,f,1943,3245,92083,20043,1232,4350,4203,29828
u,m,2005,12625,165632,64981,4610,13411,14375,97377
u,m,1847,751,39805,3015,249,1083,505,4852
u,f,1818,292,9779,1223,119,429,433,2204
m,f,1924,3093,237315,84351,6560,17839,43552,152302
f,f,1959,2901,372394,139387,9253,22738,69555,240933
f,f,1844,690,172610,23179,2128,6823,19438,51568
f,f,1956,3304,510963,176765,13057,29945,88543,308310
f,u,2000,10323,741366,314516,22187,60227,186039,582969
m,m,1927,18295,1725982,520724,38760,108688,270875,939047
f,u,2012,0,0,0,0,0,0,0
f,f,1930,3000,350989,155275,11769,29896,88516,285456
f,u,1894,341,49813,12714,951,2520,8780,24965
f,u,1895,415,55861,12222,1027,2873,9542,25664
m,u,1972,22593,1544325,564254,41043,109818,280441,995556
u,f,1955,3210,53655,15004,1085,3139,3018,22246
m,m,1823,1954,227936,29721,2642,9313,23786,65462
m,u,1813,25,3094,836,101,250,588,1775
u,u,1962,18228,385884,99778,6333,22848,19200,148159
u,u,1821,74,398,81,8,46,24,159
m,m,1879,2463,317753,60575,5577,15522,37526,119200
f,m,1966,7423,606644,239997,17097,43645,123157,423896
f,u,1803,80,10322,1313,122,495,1389,3319
m,f,1804,179,8470,3836,400,1074,2710,8020
u,u,1919,1352,24857,4736,419,1181,1082,7418
m,m,1962,21168,1850025,665741,44146,113497,277526,1100910
m,f,2010,175,10773,4723,334,818,1856,7731
f,f,1971,3293,275744,119667,8922,20427,60128,209144
f,f,1987,6928,979415,386887,26129,63308,206496,682820
u,u,1863,182,3572,582,72,150,126,930
f,m,1980,7698,706467,269622,18715,48022,131804,468163
u,u,1891,600,14504,2388,221,647,601,3857
f,u,1900,781,96029,19958,1681,4497,13093,39229
u,f,1829,337,11888,941,99,339,286,1665
u,m,1973,12664,223173,57864,3809,11129,12092,84894
u,f,1899,3088,96652,13248,1206,3542,3393,21389
u,u,1985,19198,343576,111100,7511,22568,24750,165929
f,u,1856,345,80266,8901,779,2565,7596,19841
f,u,1881,329,38540,7036,684,1863,4882,14465
m,m,1971,24865,1733066,675293,44429,115155,302206,1137083
u,u,1987,17847,301397,97907,6754,20287,21302,146250
f,m,1866,1498,270733,40623,3744,11590,31508,87465
u,u,1979,17279,367549,94761,6350,19355,19771,140237
m,u,1980,24898,1404714,623834,43340,113610,308908,1089692
m,u,1872,914,89420,20830,1991,5267,13708,41796
u,f,1903,2048,54027,8443,664,2022,1948,13077
m,f,1979,10267,817632,311595,22001,56200,137114,526910
m,m,1967,24850,1953227,802310,52632,138691,350812,1344445
m,u,1984,25190,1225022,571293,42063,107519,284725,1005600
u,u,1892,680,16037,2156,188,646,681,3671
m,u,1936,14995,1079445,354094,27564,69522,186777,637957
u,f,1824,301,13949,1082,88,431,177,1778
u,f,1977,3659,96486,26229,1637,4581,5193,37640
m,m,1842,2161,440927,63893,4281,18551,42846,129571
u,u,1816,76,2033,132,19,52,36,239
u,m,1888,5211,177230,18000,1558,5268,4071,28897
m,u,1873,614,77539,13872,1247,3565,8229,26913
u,f,1965,3533,74786,20533,1402,4169,4211,30315
u,f,1923,1378,25542,6492,574,1664,1387,10117
f,u,1873,292,56155,9973,985,2620,7037,20615
m,f,1982,12005,867830,329412,24191,61008,147481,562092
u,f,1895,2711,70552,8948,869,2598,2155,14570
m,f,1857,2000,289362,53251,5198,14332,35589,108370
f,m,2007,7713,530031,291940,19528,49694,151745,512907
m,u,1918,1539,152651,33771,2297,7534,16415,60017
f,u,1936,5216,527080,178730,14019,33563,101059,327371
f,u,1825,158,16148,3466,397,970,3065,7898
m,f,1942,6327,604737,187661,14356,35437,83969,321423
f,m,1911,4997,921785,174214,13663,38479,104288,330644
m,m,2006,24833,1353573,692761,44310,118185,318491,1173747
f,f,1974,3584,431193,169805,12277,30223,89103,301408
f,f,1928,2537,348728,127636,9114,23290,73483,233523
f,m,1844,1066,230336,29187,2098,10292,24219,65796
f,m,1818,196,28378,3216,276,938,2660,7090
f,u,1992,13311,833600,435125,32180,80580,252427,800312
m,m,1945,15301,1307607,461069,31721,76933,195089,764812
m,u,1968,36730,2024182,809880,60150,171433,411116,1452579
f,f,1900,3119,594080,110425,9039,24813,73547,217824
f,f,1804,129,7032,3311,341,957,2417,7026
m,f,2007,15932,946357,501828,34854,90713,231624,859019
f,u,1978,8014,647170,286025,20713,53819,160325,520882
m,u,1856,609,88144,9828,887,2843,7150,20708
m,m,1863,2489,325438,50850,4490,14213,33550,103103
m,u,1933,12962,1135876,364204,27379,73878,184609,650070
f,u,1973,7081,429559,229581,18349,45800,129041,422771
f,f,1923,1417,175256,66113,5398,13112,37672,122295
u,u,1918,863,17677,3227,235,830,548,4840
u,f,1938,3307,61729,16963,1217,3736,3517,25433
u,m,1914,6459,173499,24485,2010,6850,5475,38820
u,u,2005,17794,301051,97328,6940,19832,23299,147399
f,u,2002,8299,614894,260361,18721,49463,157822,486367
f,m,1929,5802,620607,214250,16619,43923,121638,396430
u,m,1852,2210,76981,6016,597,2140,1072,9825
f,f,1988,7827,1020503,404571,25725,64376,211450,706122
u,m,1813,68,518,120,10,63,37,230
u,f,1817,288,12983,1673,114,591,471,2849
u,f,1810,455,10556,1644,82,576,431,2733
u,m,1893,7841,315150,37227,2536,11201,5613,56577
u,u,2010,818,7292,3949,297,819,657,5722
m,u,1803,149,16096,2956,232,1113,2297,6598
u,f,1846,409,12512,1335,127,471,309,2242
u,u,1995,18310,319489,98017,7004,20997,22630,148648
u,m,1982,13120,322722,83013,5071,15198,16732,120014
f,m,1981,7821,752099,299504,20560,51497,149406,520967
u,u,1859,243,4126,511,62,172,112,857
u,m,1854,1702,41360,3528,354,1223,841,5946
u,f,1861,579,13670,1709,192,589,425,2915
m,f,1888,3927,479235,96408,8877,23627,55801,184713
u,f,1970,4789,77644,22999,1749,4995,5171,34914
u,m,1947,11600,203432,52954,3894,11451,10821,79120
m,u,1940,9737,889655,301537,20824,55545,142412,520318
f,u,1920,1086,167313,35196,2855,7438,21604,67093
m,u,1969,34291,2200020,798342,60477,160550,419483,1438852
m,u,2012,0,0,0,0,0,0,0
u,f,1831,279,18765,959,90,379,264,1692
u,m,2000,14648,250921,75838,5202,15493,16166,112699
m,u,1911,2253,237689,43797,3231,10612,21751,79391
u,m,1919,6844,159759,27712,2245,6845,6071,42873
f,m,1948,5820,636838,221489,16165,40619,113155,391428
f,f,1805,69,11527,3375,210,1354,3296,8235
f,m,1898,4826,834620,147406,11916,36641,96715,292678
m,f,1893,6463,838929,164773,14634,39364,92001,310772
f,f,1982,6373,846442,334051,21900,53446,167840,577237
u,f,1914,3266,92305,14371,1072,3393,3186,22022
m,f,1813,562,86363,12784,1001,4065,12437,30287
m,f,1852,1655,273871,40058,3370,10195,27507,81130
f,m,1994,7057,477625,223751,14995,38937,115904,393587
m,f,1898,6101,723766,137093,12014,31963,80125,261195
m,f,1965,6030,566364,218004,15244,39874,93568,366690
f,u,2005,9522,577886,309336,22623,58491,182331,572781
m,m,1855,3075,421225,59643,4468,16431,38570,119112
m,u,1905,2090,232486,41254,3297,10157,23450,78158
u,f,1889,2535,95115,10669,952,3110,2608,17339
u,f,1978,4551,109542,31437,1888,5570,7469,46364
u,u,1881,372,5713,919,100,284,229,1532
f,m,2000,8667,649796,298528,19699,51793,155460,525480
f,m,1989,9377,838659,349764,23803,61760,179614,614941
f,f,1924,1790,247479,84357,6762,16384,50746,158249
u,u,1986,18128,350555,100399,6881,20005,21279,148564
m,f,2003,14070,876094,432811,31771,79199,197255,741036
m,u,1879,1205,199267,33934,3058,8785,20899,66676
m,u,1953,19192,1323649,460248,33168,89248,229992,812656
f,m,1924,5003,620771,209282,15759,41146,118545,384732
m,u,1962,25425,1942953,686269,48006,137410,346861,1218546
u,m,1961,12121,212816,59316,3791,11406,11449,85962
m,m,1984,26768,2303802,845103,54569,143817,377658,1421147
u,u,1975,17683,354201,91174,6553,19608,17985,135320
m,u,1914,1921,225734,37620,3195,9369,21751,71935
u,f,1939,2372,46628,13079,939,2758,2470,19246
f,u,1886,441,62876,12924,1263,3343,10632,28162
u,m,1959,11840,257458,64023,3838,12295,11925,92081
f,u,1845,165,22973,2561,214,739,2106,5620
u,u,1830,705,33920,2301,195,889,538,3923
u,m,1802,14,714,38,6,15,3,62
u,m,1924,7852,131761,28412,2186,7154,6861,44613
m,u,1884,515,56225,10870,1148,2954,5791,20763
u,u,1976,18706,306165,85981,6315,18495,18015,128806
f,f,1818,442,76395,14142,1376,4675,12883,33076
f,f,1898,3385,706418,122299,10542,27809,86606,247256
m,u,1954,16051,1329238,485495,34066,91858,241296,852715
m,m,1931,13160,1370785,424639,28255,80577,204012,737483
m,u,1931,14981,1191080,405076,30635,83962,213194,732867
u,m,1939,6923,153347,32049,2291,6872,6667,47879
f,f,1832,726,141228,20393,1995,6142,17502,46032
f,m,1882,2178,332691,71553,6503,17880,50396,146332
f,m,1917,3982,647215,148582,11609,31588,87452,279231
m,f,1836,1074,168288,24144,2089,7358,17473,51064
u,m,1851,1093,44860,3836,309,1459,520,6124
m,f,1859,1316,189716,30607,2780,8336,21716,63439
u,u,1998,18769,322406,97459,7182,20723,24355,149719
u,f,1961,3881,85405,28137,1880,5511,5361,40889
m,m,1856,3706,461204,68765,5607,19407,44068,137847
f,f,1890,2700,528518,104115,9580,24910,72982,211587
u,f,1902,2211,66110,10417,843,2638,2904,16802
f,m,1869,1316,189637,34205,3417,9136,24187,70945
f,m,1883,4353,629401,119449,11337,31062,84892,246740
m,u,1828,349,32670,4594,474,1367,3004,9439
m,u,1817,136,8562,1882,194,706,1692,4474
m,m,1801,541,48842,7714,675,2731,6195,17315
m,m,1867,2877,447927,70959,6528,18587,43057,139131
m,f,1973,8955,555296,218687,17106,41966,101869,379628
m,f,1926,3913,302354,103304,7965,21114,51597,183980
m,m,1865,3589,542872,81035,6775,22357,51578,161745
u,u,1914,1111,37440,4664,359,1230,1030,7283
m,u,1909,1582,173631,35646,2807,8151,20410,67014
f,m,1939,3738,419680,132297,9887,24882,68585,235651
f,u,1820,47,12482,1651,146,530,1023,3350
m,m,1969,28414,2073512,809265,53820,137740,348625,1349450
f,u,1838,89,14606,1929,175,580,1867,4551
u,u,1991,22585,380429,120126,8269,24819,26087,179301
f,u,1967,10295,883998,354808,27646,72049,210386,664889
m,m,1847,1737,262742,37656,2855,11270,25639,77420
m,f,1853,1573,248949,37555,3596,9925,25646,76722
m,m,1912,16141,2282986,469861,34399,103963,233114,841337
m,m,1890,10138,1462443,229409,18901,56696,140192,445198
f,m,2005,7796,553721,278120,18168,48198,145005,489491
u,f,2012,0,0,0,0,0,0,0
f,u,1884,222,28630,7057,734,1775,4292,13858
m,m,1833,2252,304036,32796,2677,9686,25857,71016
f,m,1885,2325,406718,73422,6378,18197,50471,148468
u,m,1901,5460,155675,20374,1520,6125,4033,32052
m,m,1885,7555,901789,154782,13670,39135,92579,300166
f,f,1922,5216,1039119,233535,18670,47696,138512,438413
u,u,1861,222,4693,783,69,225,134,1211
u,u,1938,7806,118495,37317,2659,8299,7448,55723
u,f,1859,491,10162,1686,110,438,346,2580
u,u,1923,12485,309921,62830,4113,15062,13192,95197
u,m,1970,14088,249506,74075,4625,13593,14997,107290
u,u,1846,227,12569,707,56,266,94,1123
u,u,1952,11636,316571,69028,4557,15163,14111,102859
u,u,2000,15769,244102,84177,5732,16974,19624,126507
f,m,1889,2778,434171,85246,7442,21085,58026,171799
f,u,1977,9670,785588,324860,24192,62533,179444,591029
m,f,1868,2433,343634,67403,5903,17015,39732,130053
u,m,1943,7866,148919,35431,2537,7750,6069,51787
f,u,1834,130,22784,2610,194,751,2486,6041
u,m,1838,640,23024,1953,160,655,365,3133
u,u,1877,185,5776,387,62,125,82,656
m,f,1937,6374,562281,194237,14450,36458,88439,333584
f,f,1908,3213,707327,139396,10805,28229,85258,263688
f,m,1942,3868,373382,138775,10227,27050,70494,246546
u,f,1945,2786,79061,18911,1368,3818,3774,27871
f,m,1970,8578,665284,273018,19768,50408,137982,481176
m,u,1985,27500,1424913,643899,47115,119646,316401,1127061
m,f,1864,2550,386988,60096,5258,16046,36508,117908
f,m,1975,6427,528362,212009,14087,38286,108024,372406
f,u,1897,287,34820,7656,706,1755,5396,15513
m,f,1995,13065,817124,386881,27003,70334,175201,659419
u,m,1859,2631,102486,7780,648,2271,1550,12249
f,m,1806,112,9816,1784,158,581,2129,4652
u,u,1822,258,4958,512,37,233,217,999
m,u,1844,264,27326,5861,398,1749,4364,12372
m,u,1910,1884,224660,44811,3251,9782,24173,82017
u,u,1947,10911,226765,58202,4059,12584,11273,86118
u,f,1909,2664,79992,11064,922,2633,2397,17016
m,f,1845,2673,335305,47144,4373,15831,43845,111193
m,f,1993,11344,666977,314388,21750,57404,146942,540484
u,u,1908,1501,30427,4780,523,1160,1001,7464
m,m,2012,0,0,0,0,0,0,0
f,f,1902,2256,434692,81603,6728,17840,52913,159084
f,f,1869,1576,361707,67474,6367,15757,49079,138677
f,u,1850,16,1484,278,26,70,251,625
m,f,1890,5272,645386,126263,11583,31404,75031,244281
u,u,1961,17343,338736,95360,7011,20481,20296,143148
u,u,1858,793,19996,2063,178,637,606,3484
m,m,2003,25022,1575454,693313,44504,117258,312907,1167982
f,m,1944,3329,327200,119982,8678,22207,59080,209947
m,f,1862,1334,189616,32400,2922,9041,18558,62921
u,m,1975,11903,202328,57649,3660,11115,11301,83725
u,f,1973,4422,68773,20690,1522,4247,4697,31156
f,m,1903,3323,539949,105740,7877,24456,66930,205003
f,f,1854,1148,261308,46837,4310,12400,36520,100067
u,m,1840,1856,38220,3935,341,1557,703,6536
u,f,1865,1202,41646,4197,417,1309,1118,7041
m,m,1905,10619,1453023,276739,20318,63422,148880,509359
f,u,1974,7014,454669,223318,17595,46430,134697,422040
f,u,1859,293,34259,7911,672,2069,6441,17093
u,m,1915,6041,174358,25164,1879,6703,5514,39260
f,u,1821,112,19897,5214,411,1681,5451,12757
u,m,1881,2733,72121,9507,857,2869,1970,15203
u,u,1802,20,664,39,1,19,11,70
f,u,1892,451,53868,12718,1091,3269,10239,27317
f,f,1921,3520,907373,199161,15069,40239,113899,368368
u,m,1899,12320,394884,49170,4092,13500,12209,78971
m,f,1823,576,80948,15378,1372,5051,12039,33840
u,m,1871,2028,56688,6727,613,2223,1164,10727
f,m,1834,646,154450,15442,1291,4779,14212,35724
u,m,1862,1522,42228,5053,447,1398,790,7688
f,m,2003,7838,616044,284561,18861,49008,148388,500818
m,u,1836,187,14629,2502,262,783,2475,6022
u,u,1939,6801,189472,35819,2539,7782,7672,53812
m,m,1953,18715,1877126,631193,41473,109596,279617,1061879
m,m,1843,1874,295467,38015,2761,11080,27867,79723
u,m,1977,11524,244170,66209,4176,11955,13649,95989
u,m,1964,13178,230616,66844,4607,13386,12940,97777
m,m,1951,19101,2017200,684183,45802,118332,297986,1146303
m,f,1971,6960,497488,196499,14268,34255,85837,330859
u,u,1936,9389,168552,40342,3043,8851,8961,61197
m,m,1875,2844,429864,74354,6399,18884,44568,144205
m,f,1944,7041,782693,227174,16429,41983,104474,390060
m,u,1808,126,13476,1724,175,573,1251,3723
f,f,1884,2328,453298,95430,9219,22137,66958,193744
m,f,1869,2584,352962,61415,5743,15715,36977,119850
m,u,1883,644,64508,10542,1116,2837,6923,21418
m,f,1994,14600,896484,427117,28885,77306,195602,728910
u,f,1880,2828,104041,13880,1024,4122,3447,22473
u,f,1940,2718,62127,13665,1026,3112,2741,20544
f,m,1871,1122,167303,35502,3084,9985,27005,75576
f,f,1876,2021,463530,81434,7431,19348,58371,166584
f,m,1836,772,128576,14018,1207,4353,13258,32836
m,m,1942,15313,1333548,486797,32567,89268,219921,828553
m,f,1917,6544,890237,194882,14835,41482,96580,347779
u,u,1978,17414,384775,99935,6657,21019,21962,149573
u,f,1927,2130,43331,10913,944,2608,2788,17253
f,m,1964,6662,578965,233602,17109,42983,116218,409912
u,u,1889,476,12032,1540,142,408,437,2527
u,m,1884,4095,90640,11730,1105,3855,2760,19450
f,m,1855,1004,177987,25866,2231,7983,18902,54982
m,m,1923,14311,1471513,453545,33240,91187,241385,819357
m,f,1964,6203,482489,192926,13787,34067,82154,322934
f,u,1848,185,18323,3227,353,1113,3118,7811
f,f,1845,1226,213734,31464,3130,10558,35594,80746
u,m,1911,6514,170926,23893,1834,6352,5167,37246
f,f,1806,132,20363,5352,437,1901,5549,13239
m,f,1953,6549,607210,221672,16026,40503,96492,374693
m,m,1996,24510,1593874,690003,43564,118425,313353,1165345
u,u,1901,1496,32975,5155,451,1529,1247,8382
u,u,1829,37,639,69,10,31,37,147
f,u,1871,259,43392,7190,736,1743,4802,14471
m,f,1877,2650,333258,63964,6040,15937,39563,125504
m,f,1897,6220,896179,170167,14605,39015,99411,323198
m,f,1887,5278,663534,134082,12296,32798,78970,258146
m,f,1960,7137,659938,233707,16298,41537,98059,389601
u,u,1831,126,5322,289,32,101,49,471
u,u,1886,480,12643,1210,146,412,312,2080
f,f,1893,3924,922137,166856,14979,37364,110307,329506
u,m,1857,2308,92271,8212,683,2854,1608,13357
f,u,1840,87,7872,856,80,323,1064,2323
u,m,1855,1253,37160,3947,280,1189,828,6244
f,m,1947,6910,791142,257663,19305,46331,128197,451496
m,u,1897,813,89555,15702,1241,3618,9631,30192
u,u,1928,10886,181909,46430,3376,12393,9108,71307
m,m,1909,13025,1887341,341909,24670,78653,179242,624474
u,u,1834,289,9064,835,51,250,156,1292
u,u,1943,8052,147091,36663,2427,7881,7108,54079
u,m,1844,2249,69340,5557,503,2109,1016,9185
f,f,1990,7803,885861,383099,25827,64570,198478,671974
f,f,1838,635,139883,17754,1568,5643,17982,42947
u,u,1803,90,760,100,15,36,17,168
m,f,1934,6455,520439,193671,15204,38821,94313,342009
u,m,1837,1139,49394,3694,303,1323,758,6078
m,u,1912,1837,201122,38992,2880,8424,20211,70507
m,f,1817,597,104724,19015,1319,5283,16082,41699
m,u,1810,199,5901,1138,109,408,1033,2688
f,m,1904,3254,520911,100464,7699,22835,61593,192591
u,m,1861,851,25254,2520,224,701,466,3911
m,u,1832,1040,93053,11783,1031,3417,11463,27694
f,u,1910,574,90935,17613,1275,3803,11289,33980
m,u,1826,173,8186,2795,194,1040,2153,6182
m,u,1904,1819,189206,40178,3372,9240,21057,73847
u,u,1970,23251,428487,114009,8161,25027,22786,169983
f,f,1851,771,211170,33000,3026,9485,30162,75673
u,u,1870,185,8867,604,53,159,209,1025
u,f,1888,1782,55972,7422,756,2202,1995,12375
f,u,1985,10167,797448,341959,25876,63341,193823,624999
m,u,2008,14101,711730,362129,26619,69751,181169,639668
u,m,1824,688,15277,1307,112,549,304,2272
f,u,1961,8109,744599,294677,22593,55736,168055,541061
m,u,1849,384,40861,7814,713,2053,5714,16294
f,f,1994,7855,772865,413139,25692,65035,217044,720910
m,f,1849,1074,147230,24486,2038,6950,18911,52385
f,u,1829,87,14410,2625,270,796,1941,5632
m,f,1899,6699,944394,161415,13692,36393,88787,300287
u,u,1820,52,1103,109,13,32,28,182
m,f,1948,7211,677903,238799,17445,43846,104105,404195
f,u,1902,916,148309,27438,2075,5838,18480,53831
f,m,1982,7186,710107,274906,18022,47646,132604,473178
u,f,1944,3149,72908,15673,1206,3434,3431,23744
m,f,1969,7539,627355,230948,16364,41346,100569,389227
u,f,1857,736,17206,2166,221,726,513,3626
f,u,1860,455,78043,12835,1099,3642,10718,28294
m,m,1904,11229,1320073,258723,19797,59626,136682,474828
u,u,1840,174,5420,498,53,150,87,788
m,m,1959,20855,1926854,649169,41662,109635,286466,1086932
f,f,2008,7579,520349,391736,24988,64226,203015,683965
m,f,1871,2369,354749,62768,5558,15846,38004,122176
u,u,1920,1518,42487,6452,524,1647,1527,10150
f,m,1997,8426,692761,299982,19496,52395,154473,526346
f,f,1853,1145,303522,42494,3723,11294,33943,91454
u,f,1848,363,11853,841,87,311,170,1409
f,f,1882,2272,507725,94622,8362,22612,65696,191292
f,u,1963,6972,625893,229747,17233,45169,132838,424987
m,u,1976,29795,1886278,721339,53330,142937,359028,1276634
