chargender,authgender,date,characters,speaking,agent,mod,patient,poss,total
u,m,1902,4616,115734,16771,1351,4645,3400,26167
u,m,1835,990,38203,3068,301,1006,701,5076
m,f,1795,114,9836,2502,172,777,1523,4974
u,u,1741,10,266,55,6,15,8,84
m,m,1997,23590,1773508,752717,47437,131189,350499,1281842
f,u,1815,219,29581,5144,493,1525,4194,11356
m,f,1741,0,0,0,0,0,0,0
m,m,1798,162,29143,3697,270,1408,3306,8681
m,u,1833,164,17625,3102,245,916,2169,6432
u,f,1773,0,0,0,0,0,0,0
m,m,1791,52,5371,854,70,287,851,2062
u,u,1865,287,8431,1001,105,319,370,1795
f,u,1862,328,73930,11494,988,2704,8083,23269
f,m,1785,56,6824,4855,381,1856,4067,11159
m,m,1887,7385,957993,187118,15784,44139,106661,353702
f,f,1952,3148,407653,153333,11374,27480,79964,272151
u,f,1778,0,0,0,0,0,0,0
m,m,1929,17242,1573051,515439,37554,104024,255780,912797
f,f,1991,5569,550991,290023,20079,48353,150320,508775
m,m,1803,305,11096,2274,220,886,1581,4961
f,f,1826,313,74829,10542,879,3323,10310,25054
f,f,1941,3298,504009,155181,11301,27855,85079,279416
u,m,1971,11460,179387,52405,3601,10461,10475,76942
u,u,1971,18055,387325,95795,6342,20748,20605,143490
u,u,1768,11,49,22,0,4,4,30
f,f,1946,3927,601074,197619,14330,34103,102357,348409
f,m,1964,6055,549443,223676,16369,41065,111485,392595
m,u,1934,11874,776324,290210,22073,58238,149123,519644
m,u,1856,609,88144,9828,887,2843,7150,20708
u,f,1833,610,21045,1635,155,690,478,2958
f,m,2003,7098,588782,272212,17851,46566,141917,478546
u,m,1831,1839,72227,4320,333,1394,1036,7083
f,u,1813,33,7042,1787,146,574,1660,4167
m,u,1957,22427,1813743,637376,47590,121199,299431,1105596
u,u,1892,680,16037,2156,188,646,681,3671
f,u,1851,176,22514,3570,337,1001,3458,8366
u,u,1994,24447,387507,125151,9302,26641,28707,189801
f,f,1794,86,5300,1636,193,708,2161,4698
u,u,1709,0,0,0,0,0,0,0
m,m,1846,2893,460326,58198,4203,17881,43183,123465
f,m,1993,6262,438584,218943,14604,38512,112266,384325
m,u,1885,605,57692,10177,970,2688,6229,20064
u,f,1844,620,13211,1753,181,627,394,2955
u,u,1712,0,0,0,0,0,0,0
u,f,1826,351,18769,1509,126,462,522,2619
f,f,2002,6309,586105,306905,20665,49861,164993,542424
f,f,1806,149,20479,5610,466,2015,5922,14013
u,f,1946,3421,69312,16403,1261,3599,3300,24563
f,m,1776,0,0,0,0,0,0,0
m,u,1770,0,0,0,0,0,0,0
m,u,1887,582,65446,11502,998,2832,7363,22695
m,m,1767,75,1650,840,54,211,615,1720
u,f,1777,0,0,0,0,0,0,0
f,f,1729,0,0,0,0,0,0,0
u,f,1849,545,14855,1487,135,454,495,2571
f,f,1916,3201,842550,165535,12542,32095,97496,307668
u,f,1754,0,0,0,0,0,0,0
u,u,1964,18644,342401,97546,6609,20406,19170,143731
u,f,1775,3,0,2,0,1,1,4
u,f,1782,0,0,0,0,0,0,0
f,f,1778,0,0,0,0,0,0,0
u,m,1729,0,0,0,0,0,0,0
u,f,1728,0,0,0,0,0,0,0
u,f,1910,2730,88810,12216,1050,3180,3110,19556
f,u,1972,9472,796320,308152,23526,61272,177187,570137
f,m,2010,73,4265,3635,264,561,1795,6255
u,m,1723,0,0,0,0,0,0,0
u,u,2005,20800,345417,118153,8180,23599,26962,176894
f,m,1977,5869,495688,202012,13853,35042,101735,352642
m,m,1814,21,205,149,9,37,85,280
f,m,1953,5458,607067,216431,15005,38651,105631,375718
u,f,1893,2997,99029,11494,1068,3197,2886,18645
f,u,2002,10425,752189,324648,22821,60145,188534,596148
f,f,1965,2507,295962,119273,8665,21454,59147,208539
f,f,1723,0,0,0,0,0,0,0
u,u,1841,83,1964,208,18,82,53,361
m,m,1911,13922,2147970,394313,28455,89503,206995,719266
m,u,1878,600,73930,14692,1084,3571,7920,27267
u,f,1770,51,0,120,13,55,25,213
u,m,1996,10610,164399,51091,3259,9924,11947,76221
f,f,1817,368,95189,13103,1092,4201,13980,32376
f,m,1981,6951,713965,282969,19329,48405,142048,492751
u,f,1716,0,0,0,0,0,0,0
m,u,1755,0,0,0,0,0,0,0
u,u,1802,20,664,39,1,19,11,70
u,u,1819,95,779,424,44,202,85,755
u,u,1831,126,5322,289,32,101,49,471
m,f,1982,8840,777999,280439,20400,51344,129026,481209
m,f,1711,0,0,0,0,0,0,0
f,f,1866,1417,379688,61915,6013,15233,47960,131121
u,f,1965,2958,62384,17266,1173,3519,3676,25634
f,f,1907,2784,647318,128921,9769,25378,78585,242653
f,m,1960,5787,508224,198921,15082,36937,100175,351115
m,u,1912,5748,521679,123956,8846,29185,66989,228976
m,f,1729,0,0,0,0,0,0,0
f,u,1812,78,8021,2705,239,813,2326,6083
u,m,1998,10323,191918,53728,2984,9887,11842,78441
f,f,1922,4650,951991,217114,17422,43609,131557,409702
m,f,1813,562,86363,12784,1001,4065,12437,30287
f,m,1904,3061,496404,96454,7363,21850,59532,185199
m,u,1977,30572,1753266,732685,52453,140615,354140,1279893
f,m,1803,124,4626,1517,172,625,1850,4164
f,u,1743,0,0,0,0,0,0,0
m,m,1991,21305,1310423,620214,41183,106873,285459,1053729
u,m,1946,8978,191366,45364,2997,8903,9375,66639
u,u,2000,19465,308937,100408,6882,20367,22830,150487
m,m,1861,1622,238577,37435,3092,9647,22821,72995
u,f,1858,844,23419,3312,308,932,672,5224
u,f,1988,7298,231430,61513,3813,10610,14121,90057
f,u,1904,1222,190202,36461,3012,8533,24371,72377
u,f,1781,36,1370,112,12,46,12,182
f,m,1870,1251,234939,39203,3402,10697,28614,81916
u,m,1781,190,927,235,31,80,49,395
u,u,1759,0,0,0,0,0,0,0
f,u,1720,0,0,0,0,0,0,0
m,m,1806,303,32940,4928,436,1537,4265,11166
f,u,1943,4618,438786,158074,11701,28504,80492,278771
m,f,1993,9509,584628,276760,19071,50973,131376,478180
u,f,1755,0,0,0,0,0,0,0
m,m,1995,20789,1674494,659003,40967,111166,303213,1114349
f,m,1834,646,154450,15442,1291,4779,14212,35724
u,f,1759,77,582,167,10,101,48,326
f,m,1791,48,1536,392,38,199,461,1090
u,f,1936,3537,61672,15928,1220,3753,3768,24669
f,u,1703,0,0,0,0,0,0,0
u,m,2004,11577,166687,57110,3898,11066,12987,85061
m,m,1916,13068,1911351,404209,28568,87172,205773,725722
m,u,1882,2068,173681,28374,2446,7451,18881,57152
m,u,1921,4079,478050,109269,8107,23527,52396,193299
m,m,1778,0,0,0,0,0,0,0
m,f,1904,4271,468808,94980,6894,21239,53962,177075
f,m,1924,4710,602776,204274,15237,40018,115627,375156
f,u,1784,16,1550,105,13,49,110,277
u,u,1770,0,0,0,0,0,0,0
f,f,1802,149,23211,4420,468,1715,4354,10957
u,m,1836,1175,41697,3303,288,1123,682,5396
f,u,1902,1124,169187,31024,2342,6903,20841,61110
m,f,1802,138,17685,3189,316,1031,2500,7036
f,u,1866,227,50826,7335,680,1919,5163,15097
u,u,1983,24328,440198,123768,8111,24707,26150,182736
m,m,1723,0,0,0,0,0,0,0
m,u,1728,0,0,0,0,0,0,0
f,f,1979,4186,524132,225092,16794,40161,121701,403748
u,u,1901,1792,36620,6365,545,1830,1463,10203
u,f,1967,2616,43513,13399,962,2783,2579,19723
m,m,1862,2167,253104,42605,3664,11275,29534,87078
u,m,1711,0,0,0,0,0,0,0
m,u,1844,264,27326,5861,398,1749,4364,12372
u,f,1884,2087,53074,7149,700,2092,1802,11743
u,m,1928,8323,154374,36233,2721,8910,7773,55637
m,m,1730,0,0,0,0,0,0,0
u,f,1819,164,1145,599,74,241,122,1036
u,m,1967,11519,197190,59388,3762,11892,12240,87282
m,f,1997,13169,889892,397235,27800,72783,192666,690484
f,f,1821,309,101803,19079,1472,5123,17638,43312
m,f,1721,0,0,0,0,0,0,0
m,u,1703,0,0,0,0,0,0,0
f,m,1950,6208,729239,238056,16516,42877,119813,417262
u,u,1988,22377,360979,115551,7981,23418,24694,171644
m,m,1790,50,1036,235,18,89,155,497
f,m,1729,0,0,0,0,0,0,0
f,m,1840,883,107969,19533,1665,6553,16763,44514
f,u,1822,110,23404,3496,174,1402,4370,9442
f,u,1938,3926,402277,157445,10986,28411,85456,282298
f,f,1785,64,2217,999,101,388,1028,2516
u,m,1745,0,0,0,0,0,0,0
m,f,1948,5699,607728,213389,15832,39426,94066,362713
m,u,1945,15990,1217560,422807,30776,75063,196518,725164
m,u,1931,15516,1164619,405080,30584,84088,213223,732975
m,m,1930,16945,1753568,532561,39329,105055,270273,947218
u,u,1955,15484,368850,81519,5665,17739,16617,121540
f,u,1848,185,18323,3227,353,1113,3118,7811
m,f,1871,2369,354749,62768,5558,15846,38004,122176
u,f,1944,2887,70852,14789,1125,3208,3295,22417
f,f,1953,2951,413676,153080,10338,25486,76098,265002
m,m,1974,21690,1615161,643318,41754,110036,292008,1087116
m,u,1967,36120,2316649,890597,65313,180026,446766,1582702
u,m,1732,0,0,0,0,0,0,0
u,u,1887,237,5305,612,45,177,170,1004
u,m,1788,92,89,163,11,49,28,251
m,f,1911,6183,836591,171077,13169,37181,86541,307968
m,u,1754,0,0,0,0,0,0,0
f,u,2001,10404,757636,338999,22792,59594,197620,619005
m,u,1910,4623,549193,107191,7193,26630,53686,194700
u,u,1832,507,14230,1205,103,389,396,2093
f,m,1971,6254,434919,191411,13917,35615,100734,341677
u,u,1803,90,760,100,15,36,17,168
f,m,1915,3868,702732,156251,12234,33006,89850,291341
u,f,1721,0,0,0,0,0,0,0
u,m,1768,23,0,14,5,1,5,25
f,u,1871,259,43392,7190,736,1743,4802,14471
u,f,1746,0,0,0,0,0,0,0
m,m,1850,3896,646396,81503,6539,24919,57677,170638
f,u,1787,15,1147,245,26,108,283,662
m,f,1932,4372,433028,155855,12086,30856,79657,278454
u,f,1813,239,17568,1558,99,631,507,2795
f,m,1907,3534,593969,112416,8509,24751,68594,214270
m,u,1987,29298,1437763,660378,48255,123979,315346,1147958
m,u,1775,0,0,0,0,0,0,0
u,f,1958,2827,56239,15974,1138,3290,3398,23800
f,u,1981,11229,844013,355446,27138,67243,192455,642282
u,f,1890,2838,97470,11125,1072,3478,2545,18220
m,m,1871,3265,466008,81054,7020,21039,51167,160280
f,f,1712,0,0,0,0,0,0,0
m,f,1924,3546,298719,101556,8021,20950,53092,183619
m,m,1867,2870,446904,70808,6520,18535,42976,138839
f,m,1930,5463,600786,193379,15721,40267,110233,359600
u,f,1836,384,9188,1304,119,484,307,2214
f,u,1769,21,641,315,37,209,400,961
f,m,1828,455,67348,8161,740,2760,8440,20101
u,u,1958,13932,322994,92004,5930,18117,17766,133817
f,f,1854,1148,261308,46837,4310,12400,36520,100067
m,m,1828,1272,201049,20992,1678,6999,18236,47905
m,f,1979,8266,696489,256950,18276,46512,117143,438881
u,u,1961,19218,368060,103669,7520,21947,21848,154984
u,u,1825,199,4193,411,51,138,137,737
u,f,1793,28,5135,413,18,120,114,665
m,m,1860,3422,512007,71891,6207,21186,49966,149250
u,u,1977,20097,320506,98120,7515,21132,20738,147505
u,m,1977,10498,234522,62153,3915,11173,12794,90035
f,f,1862,864,183082,29364,2781,7797,23266,63208
f,f,1714,0,0,0,0,0,0,0
m,f,1706,0,0,0,0,0,0,0
f,m,1795,28,7071,814,69,283,1103,2269
u,f,1873,1121,29042,3643,402,1040,833,5918
f,u,1913,1544,228449,46270,3840,11272,26620,88002
m,u,1829,125,24355,4193,397,1288,2785,8663
u,u,1864,297,6128,577,70,177,169,993
m,f,1804,179,8470,3836,400,1074,2710,8020
f,f,1753,34,2148,605,75,411,702,1793
u,u,2007,21367,373658,123653,7905,24676,27566,183800
f,f,1846,650,170315,24161,2103,7136,20396,53796
m,u,1956,21510,1748386,631720,44874,119912,301251,1097757
u,u,1749,0,0,0,0,0,0,0
u,m,1749,120,731,138,16,84,26,264
f,m,1938,3909,402875,146451,11157,27594,72894,258096
m,m,1936,14106,1422083,453540,32023,84512,219369,789444
f,f,1929,2943,422593,151950,11838,28521,88704,281013
u,u,1715,0,0,0,0,0,0,0
u,m,1730,0,0,0,0,0,0,0
u,u,1923,12857,311720,63209,4176,15258,13303,95946
f,f,1791,96,20087,3576,279,1369,3313,8537
m,f,1955,5832,557862,191538,13324,34894,85754,325510
f,f,1992,5555,612240,309537,19540,48636,159728,537441
m,m,1809,346,21085,4916,372,1616,3521,10425
f,u,1979,11147,910556,360792,27656,68972,202036,659456
u,f,1970,3797,56422,15830,1263,3523,3655,24271
u,f,1955,2410,43916,11889,848,2451,2355,17543
u,u,1996,23157,374546,111638,7635,23634,26609,169516
u,m,1774,49,2087,236,16,60,51,363
f,f,1887,2880,584737,115958,10815,27336,83623,237732
f,m,1722,5,0,0,0,4,1,5
f,m,1818,196,28378,3216,276,938,2660,7090
f,f,1708,0,0,0,0,0,0,0
u,f,1710,0,0,0,0,0,0,0
f,m,1751,41,0,210,20,147,288,665
m,u,1872,914,89420,20830,1991,5267,13708,41796
u,m,1905,4467,131129,17767,1240,4694,3425,27126
m,u,1800,15,602,110,6,44,104,264
f,u,1998,12433,814380,386369,27720,70124,218291,702504
f,u,1963,8068,717790,267177,19716,51360,148647,486900
m,m,1945,13905,1260088,438616,29950,72638,186139,727343
u,f,1823,276,9522,1035,86,312,190,1623
u,f,1897,3497,131297,15639,1351,4310,4027,25327
f,m,1871,1122,167303,35502,3084,9985,27005,75576
u,f,1812,201,3465,691,60,286,212,1249
u,u,1984,19862,389174,101380,6568,23440,20166,151554
f,u,1949,5849,516998,202700,14663,36764,105749,359876
m,f,1854,1664,223072,43584,4109,11717,30062,89472
u,u,2003,17575,331052,101840,6855,20133,22066,150894
f,f,1968,2738,316155,138718,9585,24179,71359,243841
u,u,1845,270,9368,941,70,292,149,1452
m,u,1839,559,81659,10325,729,3462,7474,21990
u,f,1978,3639,95074,27222,1609,4789,6608,40228
f,u,1818,97,11603,2544,295,883,2926,6648
m,f,2003,12008,786602,387470,28338,71044,178489,665341
u,f,1887,2908,107441,11794,1056,3593,2818,19261
m,u,1925,12711,981460,316451,24425,71608,176331,588815
u,m,2000,12501,211327,68850,4651,13864,14705,102070
u,m,1990,15730,340832,88539,5022,15539,18605,127705
u,f,1975,3126,68853,16350,1060,3205,3638,24253
f,u,1789,35,3890,721,112,398,941,2172
f,u,1890,406,56546,9872,923,2410,7058,20263
u,f,1997,6326,116685,34155,2155,6147,8623,51080
m,u,1857,992,118971,20205,1834,5343,14401,41783
m,u,1951,19726,1674176,637667,47205,124062,311346,1120280
u,u,1900,17234,454319,76268,5481,19895,14973,116617
f,f,1950,3158,482171,186451,12856,31040,91746,322093
m,f,1873,2618,398762,71384,6505,17729,40349,135967
u,f,1868,1010,30998,3106,316,960,751,5133
u,f,1804,97,5046,317,28,132,33,510
u,f,1708,0,0,0,0,0,0,0
f,u,1755,0,0,0,0,0,0,0
u,m,1733,24,0,30,3,5,2,40
u,f,1986,4613,122088,32473,1927,5467,7699,47566
u,f,1925,1657,30200,9093,742,2014,2203,14052
m,f,2010,6,0,60,2,8,54,124
f,f,1985,5144,711388,305548,20483,50907,164781,541719
m,m,1957,16598,1676944,588369,37083,97634,246319,969405
m,u,1944,12049,781043,274532,19619,50516,132171,476838
m,f,1951,6164,574106,199059,14654,36121,90814,340648
u,f,1815,376,23737,1977,154,651,352,3134
f,f,1905,2239,446971,87210,6398,17950,55134,166692
m,m,1899,20900,2484212,439347,34200,106580,251449,831576
m,u,1704,0,0,0,0,0,0,0
u,f,1807,243,2665,739,42,343,133,1257
m,f,1723,0,0,0,0,0,0,0
u,m,1857,2308,92271,8212,683,2854,1608,13357
u,u,1857,353,9297,949,94,302,181,1526
f,m,1706,0,0,0,0,0,0,0
u,f,1784,11,1107,22,2,3,0,27
u,f,1796,98,178,175,26,58,33,292
m,m,1996,20472,1461537,622904,38346,105103,285459,1051812
u,m,1864,1673,47538,4289,476,1504,1256,7525
f,m,2005,6972,508835,254761,16596,44513,135008,450878
m,f,1938,7240,668495,218426,17665,44226,105085,385402
m,m,1866,5147,903077,149886,11766,36926,90158,288736
f,m,1745,0,0,0,0,0,0,0
f,u,1765,8,31,82,11,20,64,177
m,f,1972,4404,324438,135550,9829,24713,61132,231224
f,u,1821,112,19897,5214,411,1681,5451,12757
f,f,1879,1317,321592,63368,6190,14133,44170,127861
u,u,1776,0,0,0,0,0,0,0
m,m,1922,19313,2264238,550463,40754,113490,275678,980385
m,u,1847,259,37572,4492,351,1864,3717,10424
f,m,1813,68,3138,394,36,182,422,1034
m,f,1835,2638,351867,56949,5040,15716,40937,118642
m,f,1751,26,3357,1209,115,444,711,2479
f,u,1829,87,14410,2625,270,796,1941,5632
u,u,1936,10305,174265,41936,3173,9310,9324,63743
u,u,1710,0,0,0,0,0,0,0
u,f,1843,508,18598,1661,133,580,360,2734
u,u,1818,54,311,79,7,30,18,134
u,u,2009,4823,51719,22645,1653,4535,5056,33889
m,u,1986,32787,1831352,742006,54075,142635,358144,1296860
m,f,2001,11582,791728,363820,25454,66449,171735,627458
u,u,1796,23,552,25,0,8,9,42
m,u,1971,25986,1432301,583590,43111,113733,297196,1037630
u,u,1775,0,0,0,0,0,0,0
m,u,1761,0,0,0,0,0,0,0
f,u,1745,0,0,0,0,0,0,0
m,u,1715,0,0,0,0,0,0,0
f,u,1915,1114,134674,30571,2482,7824,18063,58940
u,u,1978,19418,405050,105859,7131,22300,23305,158595
m,f,1870,2237,312911,60346,5525,15037,35000,115908
m,m,1841,2368,364594,47036,3549,15767,34241,100593
u,u,1990,26058,491993,142690,10213,29050,31762,213715
m,f,1749,0,0,0,0,0,0,0
u,f,1919,2756,92456,12323,1032,3376,3219,19950
u,f,1848,363,11853,841,87,311,170,1409
f,f,1762,34,4099,691,84,359,1096,2230
f,f,1944,3251,566613,176507,12502,30511,90667,310187
f,u,1944,3775,321543,120615,8850,21722,65296,216483
u,m,1806,86,2463,99,21,46,52,218
m,f,1807,282,39008,11885,703,4211,10409,27208
u,u,1998,21546,376982,108149,7979,22895,26453,165476
f,f,1735,0,0,0,0,0,0,0
u,u,1827,202,4686,503,45,215,113,876
u,m,1915,5879,170330,23849,1801,6195,5322,37167
u,u,1869,155,4425,617,50,147,203,1017
u,u,1893,468,7527,1279,140,396,329,2144
u,f,1941,2765,64233,14790,1048,2978,3100,21916
u,m,1903,4944,132014,18169,1402,5058,3874,28503
u,f,1768,0,0,0,0,0,0,0
u,m,1889,4600,116948,13195,1179,4020,3200,21594
u,m,1881,2733,72121,9507,857,2869,1970,15203
u,u,1714,0,0,0,0,0,0,0
u,u,1739,0,0,0,0,0,0,0
u,m,1758,0,0,0,0,0,0,0
f,u,1993,15235,904721,464745,33542,84671,259336,842294
m,m,1822,662,74650,10057,803,2879,7567,21306
u,u,1982,21254,406627,108443,7547,22469,22915,161374
f,u,1962,9374,841330,312295,23478,59156,167637,562566
u,u,1753,0,0,0,0,0,0,0
u,u,1829,37,639,69,10,31,37,147
m,u,1734,0,0,0,0,0,0,0
f,m,1802,11,477,213,23,110,332,678
u,f,1831,279,18765,959,90,379,264,1692
u,f,1811,90,2197,373,15,123,101,612
u,m,1844,2249,69340,5557,503,2109,1016,9185
f,f,1758,23,63,75,3,28,97,203
u,f,1928,2590,54181,12761,1046,3187,2827,19821
f,f,1899,4050,893472,156994,12950,34576,106232,310752
m,m,1879,2463,317753,60575,5577,15522,37526,119200
f,f,2009,3501,193531,186214,12604,30875,103586,333279
m,m,1979,23233,2123104,763639,47104,127361,336851,1274955
m,f,1815,867,196649,22594,1680,6626,16425,47325
u,f,1989,6697,261232,55520,3260,9762,13529,82071
f,u,1737,0,0,0,0,0,0,0
f,u,1747,0,0,0,0,0,0,0
f,f,1996,7102,792329,367515,23397,59068,193458,643438
u,f,1956,2978,71596,20261,1519,3903,3789,29472
m,u,1858,1628,210036,30445,2716,7488,19219,59868
m,u,1707,0,0,0,0,0,0,0
m,f,2005,12007,802179,389503,27328,70220,183513,670564
f,m,1846,786,125213,17839,1392,5841,14872,39944
f,u,1800,5,348,27,0,7,12,46
f,f,1874,1468,336770,62479,5724,15688,43126,127017
f,m,1972,5504,416257,174988,12394,32874,89353,309609
u,f,1971,2309,34771,10794,782,2192,2595,16363
m,u,1876,825,105422,14514,1313,3867,10135,29829
f,u,1749,0,0,0,0,0,0,0
u,f,1913,2916,90490,13448,1057,3345,3484,21334
u,m,1920,6886,170725,27562,2131,7206,6001,42900
m,u,1706,0,0,0,0,0,0,0
u,u,1805,10,18,23,3,6,1,33
f,m,1758,0,0,0,0,0,0,0
f,u,1870,182,39548,5786,474,1471,4838,12569
f,m,1711,0,0,0,0,0,0,0
u,f,1996,6616,111440,33497,2230,6713,8209,50649
f,m,1944,3187,323525,118635,8573,21917,58392,207517
m,m,1865,3589,542872,81035,6775,22357,51578,161745
f,m,1712,0,0,0,0,0,0,0
u,m,1922,8066,183693,30689,2438,7850,6878,47855
u,u,1780,144,1781,311,21,114,77,523
f,f,1930,2753,351312,151020,11469,28997,86860,278346
u,u,1744,5,0,10,0,0,1,11
f,u,1805,7,218,60,3,26,86,175
m,f,1837,720,88903,13890,1162,4192,11298,30542
m,u,1797,0,0,0,0,0,0,0
m,m,1953,17415,1822384,603145,39778,104715,268698,1016336
u,u,1756,0,0,0,0,0,0,0
u,u,1810,111,711,155,17,72,54,298
m,u,1981,32150,1870993,717235,51657,138195,344390,1251477
u,m,1849,1310,35927,4003,306,1422,778,6509
f,u,1738,0,0,0,0,0,0,0
m,f,1971,4732,392193,154738,11191,26377,70023,262329
f,u,1929,6562,766724,237728,18208,52685,150646,459267
f,m,1749,50,4956,923,80,403,847,2253
u,f,1998,5029,96839,30233,1855,5695,7245,45028
m,u,1861,457,45330,7130,644,2138,5336,15248
f,m,1784,190,5338,1442,166,642,1752,4002
m,m,1762,168,4915,1080,66,366,889,2401
f,m,1919,4190,754394,169263,13279,35668,97379,315589
m,m,1984,24075,2155571,796295,51231,134381,358925,1340832
f,m,1807,75,8958,1528,120,516,1700,3864
f,u,1978,9296,741257,327555,23370,60593,178625,590143
f,u,1756,0,0,0,0,0,0,0
u,m,1786,47,3578,75,5,35,13,128
m,u,1744,0,0,0,0,0,0,0
m,f,1740,0,0,0,0,0,0,0
m,f,1750,0,0,0,0,0,0,0
f,m,1801,168,15717,2440,239,1154,2542,6375
u,f,1935,3036,61804,17286,1364,3914,3536,26100
f,m,1869,1316,189637,34205,3417,9136,24187,70945
u,f,1766,2,0,3,2,1,3,9
f,m,1786,41,9708,1394,143,478,1188,3203
m,m,1835,2004,303181,38734,3092,11817,31353,84996
f,u,1838,89,14606,1929,175,580,1867,4551
f,u,1857,448,79470,14108,1153,3803,11740,30804
u,m,1755,58,1304,138,17,53,28,236
f,m,1815,183,43800,3741,333,1027,3128,8229
u,f,1980,4961,125139,33662,2299,6338,7815,50114
m,f,1884,4307,555208,109113,10111,25376,63340,207940
f,m,1925,4142,575994,184780,14665,37770,110820,348035
m,f,1965,4979,477429,187720,13188,35052,82830,318790
f,f,1860,1497,305929,52524,4628,13386,40342,110880
m,m,1714,0,0,0,0,0,0,0
m,m,1919,13163,1994891,429326,31032,90407,214420,765185
u,f,1984,4219,117932,29706,1858,5439,7471,44474
f,m,1798,31,9743,1098,70,361,1335,2864
f,u,2009,3257,169268,115225,8165,21503,64238,209131
m,u,1718,0,0,0,0,0,0,0
m,f,1724,0,0,0,0,0,0,0
f,f,1936,4149,620823,214523,16828,40242,122422,394015
f,m,1902,2957,539649,98332,7403,23572,63540,192847
f,m,1762,19,855,1096,69,370,731,2266
u,f,1878,1526,44368,5360,529,1590,1543,9022
m,u,1727,0,0,0,0,0,0,0
m,m,1752,75,1482,1546,147,614,994,3301
m,m,1992,18080,1109294,525281,34941,89989,240227,890438
m,u,2013,0,0,0,0,0,0,0
m,u,2009,8845,302636,196454,14663,37381,96345,344843
m,m,1873,3019,440572,71127,5803,19194,44274,140398
f,f,1771,14,1351,93,8,46,81,228
u,m,1828,695,24116,1794,156,630,476,3056
m,u,1881,715,71294,14500,1346,3923,8735,28504
m,u,1966,26769,1959751,676915,48364,127489,332292,1185060
m,f,1818,610,69041,13633,1303,4307,10668,29911
f,f,1781,108,1272,1330,184,543,844,2901
u,f,1837,311,10048,782,74,275,232,1363
u,u,1728,0,0,0,0,0,0,0
u,u,1904,1597,39538,6203,520,1663,1212,9598
f,f,1926,2323,324497,112209,8568,22108,69837,212722
m,f,1734,0,0,0,0,0,0,0
f,u,1898,346,49581,10142,892,2486,7475,20995
f,m,1739,12,0,135,14,140,66,355
u,u,1809,13,32,15,1,5,3,24
m,u,1815,268,17470,3474,272,1098,2595,7439
u,f,1860,948,22900,3947,399,1226,1026,6598
f,f,2004,6161,631048,317615,21782,52819,170214,562430
u,m,1875,1484,52271,5637,526,1669,1276,9108
f,u,1708,0,0,0,0,0,0,0
u,m,1832,881,45011,3218,236,1071,777,5302
u,m,2005,11146,148998,55477,3982,11534,12690,83683
u,m,1776,0,0,0,0,0,0,0
u,u,1968,26100,408638,128385,9138,28944,26109,192576
u,m,1942,6849,122637,34979,2281,7395,6724,51379
u,m,1981,12806,287557,70971,4893,13312,14994,104170
m,u,2004,29223,1342640,643919,46732,123311,316581,1130543
m,m,1744,0,0,0,0,0,0,0
f,f,1984,4235,563423,236055,15659,38207,121436,411357
u,u,1905,1323,47439,6078,480,1492,1261,9311
f,f,2005,6457,697830,345389,22884,57594,190516,616383
f,m,1901,3300,642770,112870,8241,25620,70324,217055
m,m,1902,9570,1148351,218343,16477,53631,120449,408900
f,f,1942,2513,479587,148978,11069,26244,77863,264154
m,u,1722,16,2159,113,5,38,29,185
u,m,1993,9851,121576,44159,3186,9122,10275,66742
f,f,1980,4543,596461,268222,18552,44631,140300,471705
u,m,1944,5717,82169,23479,1739,5290,4546,35054
u,m,1845,1112,41141,3532,283,1128,608,5551
f,f,1883,2708,541068,111203,10587,25344,79845,226979
m,f,1781,63,2215,488,59,171,250,968
m,f,1801,205,18582,4908,401,1693,3963,10965
f,m,1959,5933,605192,209590,14425,36960,104809,365784
m,f,1869,2584,352962,61415,5743,15715,36977,119850
m,u,1810,199,5901,1138,109,408,1033,2688
m,u,1898,834,93583,16936,1487,4291,10200,32914
u,m,1779,0,0,0,0,0,0,0
m,m,1985,22189,1993431,737006,46052,124134,317868,1225060
f,u,1928,5049,564565,205284,16069,43433,126954,391740
f,u,1903,1406,210623,40410,3246,9093,25582,78331
m,f,1742,0,0,0,0,0,0,0
u,f,1953,2764,50225,14277,1081,3153,3180,21691
u,u,1738,0,0,0,0,0,0,0
m,m,2008,17428,965785,569631,36162,96795,263059,965647
m,u,1928,14788,1040769,401830,29567,85648,222784,739829
u,m,1746,0,0,0,0,0,0,0
m,f,1925,3397,254787,103697,8409,21806,51055,184967
u,u,1980,18657,326376,100866,6839,20270,20780,148755
f,u,1782,0,0,0,0,0,0,0
f,f,1884,2342,453300,95810,9248,22214,67271,194543
m,u,1926,16062,1018684,341214,26601,78008,190756,636579
m,m,1718,0,0,0,0,0,0,0
f,u,1910,1495,228482,40757,3144,9866,23972,77739
m,m,1707,0,0,0,0,0,0,0
m,f,1962,5433,528708,189901,13204,33733,82741,319579
u,m,1954,9132,166418,44623,2940,8539,8344,64446
u,m,1834,1300,65720,3810,292,1266,792,6160
u,u,1834,289,9064,835,51,250,156,1292
u,f,1820,266,9505,1686,117,602,344,2749
u,m,1727,167,953,429,38,151,75,693
m,f,1709,0,0,0,0,0,0,0
m,f,1857,2000,289362,53251,5198,14332,35589,108370
m,u,1767,0,0,0,0,0,0,0
m,f,1950,6427,590491,218185,16247,40604,97828,372864
u,u,1758,0,0,0,0,0,0,0
u,u,1870,185,8867,604,53,159,209,1025
m,f,1762,25,6,550,80,244,471,1345
f,m,1844,1066,230336,29187,2098,10292,24219,65796
u,m,1753,19,7,47,2,33,9,91
f,f,1752,0,0,0,0,0,0,0
m,u,1743,0,0,0,0,0,0,0
f,f,1997,6957,705555,330780,21194,55389,186459,593822
u,m,1801,300,9011,940,79,360,218,1597
u,f,1963,2772,49800,15301,1051,3067,3793,23212
f,f,1873,1755,442768,76078,6890,18184,55570,156722
f,f,1819,178,18458,3096,320,1056,3146,7618
m,m,1771,0,0,0,0,0,0,0
f,m,1835,571,110173,13921,1127,4428,12805,32281
m,u,1733,0,0,0,0,0,0,0
m,m,1786,79,12855,1910,201,673,1323,4107
m,m,1926,12843,1237716,379742,28623,78008,201376,687749
f,u,1920,2810,425518,93623,7623,21587,57803,180636
f,f,1801,149,19969,2819,267,1275,3439,7800
f,u,1933,5120,553603,187803,15667,38687,111570,353727
f,u,1971,9545,632748,267878,20924,52966,152630,494398
m,u,1892,1147,98539,18334,1514,4766,11164,35778
u,f,1749,0,0,0,0,0,0,0
m,u,1835,404,45880,5552,391,1713,4744,12400
u,u,1989,24010,423329,133544,9372,28046,28782,199744
f,m,1772,64,111,222,38,105,276,641
f,f,1963,2510,302996,129814,8958,22035,64801,225608
m,m,2004,23201,1441365,694639,43978,117037,317339,1172993
f,u,1937,4682,487637,194928,14864,36346,112587,358725
u,m,1813,68,518,120,10,63,37,230
u,u,1920,4344,132202,20417,1589,5055,4002,31063
m,m,1989,28218,2410699,922215,57164,152869,408451,1540699
u,m,1805,106,2667,510,45,203,120,878
u,f,1725,0,0,0,0,0,0,0
u,u,1826,97,9532,489,49,135,160,833
m,u,2002,28904,1462641,622129,44481,116038,303668,1086316
m,u,1778,0,0,0,0,0,0,0
f,f,1744,0,0,0,0,0,0,0
u,m,1710,0,0,0,0,0,0,0
m,m,2005,20696,1284427,635089,41144,109509,293866,1079608
u,f,1719,61,77,121,8,37,10,176
f,m,1809,97,1008,1233,91,476,1160,2960
m,m,1942,13850,1297372,467296,31248,85469,211703,795716
f,f,1958,2461,344525,118674,8058,19787,60231,206750
u,m,1854,1702,41360,3528,354,1223,841,5946
u,u,1800,13,76,22,1,6,2,31
u,m,1760,13,0,10,1,14,1,26
u,u,1944,7603,135514,34640,2493,7513,7825,52471
m,m,1711,0,0,0,0,0,0,0
m,m,1952,18024,1743759,621846,42759,108367,274893,1047865
m,m,1889,8461,991808,168200,14189,41200,99300,322889
u,f,1756,0,0,0,0,0,0,0
f,f,1897,3352,673536,126772,11096,27604,89006,254478
f,m,1742,90,11536,1521,148,490,919,3078
f,f,1759,14,2078,1143,102,480,1080,2805
m,m,1981,23232,2095772,771584,48800,127106,333737,1281227
f,f,2008,5956,447039,337269,21727,55855,179166,594017
u,m,1799,70,1343,418,36,138,100,692
m,u,1870,475,78323,12169,1064,3397,7731,24361
m,u,1943,14784,1018807,380957,26939,68578,173951,650425
m,f,1758,37,3404,708,71,434,831,2044
u,f,1969,2880,48692,15789,1002,2974,3312,23077
m,u,1749,0,0,0,0,0,0,0
f,f,1718,0,0,0,0,0,0,0
m,u,1720,0,0,0,0,0,0,0
f,f,1707,0,0,0,0,0,0,0
f,f,1970,3267,360923,141100,10367,24772,66595,242834
u,f,1838,585,17158,1136,142,528,348,2154
u,u,1903,1621,31174,4633,427,1271,991,7322
u,u,1889,476,12032,1540,142,408,437,2527
m,m,1847,1737,262742,37656,2855,11270,25639,77420
u,m,1708,120,2252,173,31,121,21,346
u,f,1791,76,2645,215,25,70,28,338
m,m,2013,21,2072,1008,132,354,448,1942
f,u,1858,726,118661,21198,1938,4941,15906,43983
u,m,1878,2810,55290,7936,750,2298,1790,12774
u,f,2008,5302,66116,33034,2350,6683,8222,50289
u,u,1911,2460,33271,6367,544,1935,1287,10133
u,u,1926,10273,186676,39129,3010,10316,8404,60859
f,m,1755,91,1224,809,75,268,771,1923
m,m,1874,3554,524847,86799,7631,21985,51578,167993
f,f,1955,2934,437088,161868,10663,26473,78028,277032
f,f,1901,2739,525644,102541,8628,21241,65340,197750
f,m,1874,1066,181957,35500,3327,9445,25188,73460
u,m,1823,1000,24759,2298,204,843,511,3856
m,u,1889,940,90266,19693,1718,4802,12343,38556
u,u,1848,169,9762,542,44,250,116,952
u,m,1898,8478,269949,35084,2741,10252,7702,55779
f,u,1724,0,0,0,0,0,0,0
f,m,2001,6796,507387,236689,15727,40822,125605,418843
m,f,1944,6519,761941,217731,15790,40406,100603,374530
u,u,1774,29,747,62,2,19,14,97
f,f,1786,47,29621,3485,289,1541,3456,8771
u,f,1990,6687,197917,49162,3255,8779,11814,73010
u,m,1869,2064,46328,4980,489,1494,1172,8135
u,f,1950,2978,57946,16372,1284,3344,3388,24388
f,u,1832,433,41732,6404,576,2080,7600,16660
u,m,1912,7139,205041,29755,2293,7487,6840,46375
f,u,1776,0,0,0,0,0,0,0
f,m,1789,32,4201,1494,150,567,1717,3928
m,f,2008,11614,578738,392420,27733,73406,185591,679150
f,m,1872,2188,386953,57618,4859,15886,40107,118470
m,m,1963,19223,1380480,564324,38298,96973,247524,947119
f,m,1894,4145,672098,121597,9698,29819,77907,239021
m,f,1999,11701,770545,375967,26523,66715,167444,636649
m,m,1935,17707,1653379,554578,40622,103520,270123,968843
m,f,1812,451,81035,13453,1122,4479,10221,29275
m,f,1838,1190,158806,20932,1970,6928,17402,47232
f,m,1716,0,0,0,0,0,0,0
m,m,1849,2575,303557,44770,3719,13138,31530,93157
u,u,1824,42,443,51,3,21,18,93
u,u,1867,327,7680,689,62,240,165,1156
f,m,1984,7274,703328,272047,18683,48157,137764,476651
f,m,1790,9,0,38,1,12,75,126
f,u,1751,9,0,37,9,32,62,140
f,m,1942,3715,370098,136880,10095,26634,69804,243413
f,m,1740,25,0,296,25,133,290,744
u,u,1949,12563,218785,58369,4072,12576,10724,85741
f,u,1983,12937,912027,392605,29228,73244,209255,704332
m,m,1756,13,16,219,9,49,121,398
m,f,2000,11215,721800,375461,27469,68486,171978,643394
f,m,1750,6,0,38,3,13,45,99
u,m,1807,68,2106,319,18,84,86,507
m,m,1988,27709,2358938,863571,53178,145130,391969,1453848
f,m,1770,4,0,48,3,17,53,121
f,f,1835,1695,320639,50629,4867,14156,44586,114238
m,m,1750,40,7746,285,24,87,210,606
f,u,1746,0,0,0,0,0,0,0
u,f,1762,11,0,27,4,13,13,57
u,m,1784,300,4357,453,43,170,162,828
u,f,1787,93,65,184,22,63,47,316
m,f,1738,0,0,0,0,0,0,0
u,u,1730,0,0,0,0,0,0,0
f,u,1954,5859,626419,222817,16005,40509,117394,396725
m,u,1804,20,1057,677,43,229,689,1638
f,m,1714,0,0,0,0,0,0,0
m,m,1772,223,3659,868,133,320,575,1896
m,u,1930,17760,1483069,498354,36371,109552,265142,909419
f,f,1986,4422,593634,249407,17025,42148,136401,444981
u,u,1791,4,0,4,0,0,0,4
u,u,1747,0,0,0,0,0,0,0
m,u,1773,0,0,0,0,0,0,0
m,u,1865,888,102809,19507,1766,4971,11595,37839
m,f,1725,0,0,0,0,0,0,0
u,f,1915,3095,74812,12476,1010,3391,2952,19829
m,m,1799,93,4635,1290,122,410,859,2681
f,f,1865,1841,521079,88989,8177,22022,65761,184949
f,f,1919,3865,829998,174008,13752,34441,106043,328244
u,f,1903,1948,52565,8318,641,2000,1920,12879
u,m,1712,0,0,0,0,0,0,0
u,u,1706,0,0,0,0,0,0,0
f,f,1847,640,177180,30256,2711,8781,26644,68392
u,u,1708,0,0,0,0,0,0,0
f,m,1724,0,0,0,0,0,0,0
u,m,1917,5481,133925,22420,1804,5925,4817,34966
u,f,1881,1809,51759,6876,608,1984,1628,11096
f,u,1891,452,71989,13686,1294,3538,10198,28716
u,m,1717,0,0,0,0,0,0,0
m,m,1980,23721,2116822,750962,46662,125827,327603,1251054
u,f,1760,0,0,0,0,0,0,0
m,f,1755,0,0,0,0,0,0,0
u,m,1847,751,39805,3015,249,1083,505,4852
m,m,1747,0,0,0,0,0,0,0
u,m,1798,71,684,146,16,42,77,281
m,u,1785,7,65,85,18,31,65,199
f,u,1825,158,16148,3466,397,970,3065,7898
f,u,1882,697,80194,14070,1316,3593,10515,29494
m,m,1766,27,0,67,13,36,42,158
u,u,1963,18165,387934,98819,6510,20621,19172,145122
m,f,1960,5905,593588,209490,14682,37206,88274,349652
u,u,1894,368,6101,1144,142,393,233,1912
m,m,1781,68,4986,471,32,159,431,1093
m,m,1823,1954,227936,29721,2642,9313,23786,65462
u,f,1900,2634,74672,9852,841,2621,2400,15714
m,u,1949,17585,1213286,469140,33255,91249,226895,820539
m,u,1961,26590,2046244,757439,53351,146563,388211,1345564
f,u,1790,0,0,0,0,0,0,0
m,u,1717,0,0,0,0,0,0,0
m,f,1737,0,0,0,0,0,0,0
u,m,1852,2210,76981,6016,597,2140,1072,9825
m,u,1888,1130,125582,19632,1602,4936,12115,38285
f,f,1763,0,0,0,0,0,0,0
u,u,1947,12111,242541,63045,4437,13683,12256,93421
m,f,1984,8259,719759,256057,18009,47493,121779,443338
m,f,1789,0,0,0,0,0,0,0
f,u,2003,9444,613803,293550,20970,55318,168902,538740
f,m,2008,5437,334286,216209,14333,38019,115047,383608
u,f,1806,178,7428,1315,88,474,411,2288
f,u,1923,4656,535406,158067,12718,35880,105332,311997
u,f,1748,0,0,0,0,0,0,0
f,u,1951,7004,717712,284638,21689,54466,158102,518895
m,f,1707,0,0,0,0,0,0,0
f,u,1780,28,1070,243,36,106,276,661
u,u,1863,182,3572,582,72,150,126,930
f,m,1812,128,13662,1790,140,686,1516,4132
u,f,1920,2912,63279,11192,933,2856,2822,17803
u,u,1861,222,4693,783,69,225,134,1211
f,m,1838,514,80664,11488,994,3763,10719,26964
f,f,1849,528,106843,17469,1422,4901,15605,39397
f,u,1735,0,0,0,0,0,0,0
u,u,1844,126,2271,432,39,178,88,737
m,u,1905,2958,353541,62186,4994,15317,33775,116272
m,f,1901,5064,584654,114836,9075,25374,62688,211973
f,m,2013,3,0,18,3,2,9,32
u,f,1982,4576,150688,40561,2750,7311,9451,60073
u,f,1948,2497,53213,15300,1103,3204,2948,22555
m,f,1942,5309,573559,172347,13173,32689,77934,296143
f,m,1955,6287,749857,238340,17272,42767,118277,416656
f,u,1985,12249,933734,399656,29962,73496,220390,723504
u,m,1811,198,6751,494,48,204,117,863
f,u,1715,0,0,0,0,0,0,0
u,f,1737,0,0,0,0,0,0,0
m,u,1803,149,16096,2956,232,1113,2297,6598
f,m,2000,7512,603195,277033,18033,47792,145205,488063
m,m,1705,0,0,0,0,0,0,0
u,u,1782,0,0,0,0,0,0,0
m,f,1770,44,1335,440,36,203,298,977
m,u,2012,0,0,0,0,0,0,0
u,u,1813,4,25,4,0,2,4,10
f,m,1951,6157,643970,236950,16931,43970,119227,417078
m,u,1988,33124,1802269,760733,56032,142480,370564,1329809
f,m,1969,8286,632001,263446,18877,47457,135863,465643
f,f,1957,2880,390809,148171,10934,26716,74047,259868
f,m,1738,0,0,0,0,0,0,0
m,u,1992,40127,2025211,936444,67811,178594,464426,1647275
m,m,1720,0,0,0,0,0,0,0
m,m,1905,10032,1343283,260170,19035,59141,140230,478576
u,f,1961,2914,61658,21834,1518,4480,4251,32083
u,u,1931,11695,229511,54149,3636,12596,11888,82269
m,m,1742,101,5594,1495,122,408,641,2666
f,u,1804,14,1744,890,43,270,927,2130
u,u,1937,8457,168021,39960,3234,9006,7771,59971
f,f,1956,2909,473186,164930,12257,28146,83377,288710
u,m,1858,1577,63413,6611,450,2109,755,9925
u,u,1750,0,0,0,0,0,0,0
u,m,1906,5009,132825,19503,1592,5277,4269,30641
f,m,1725,0,0,0,0,0,0,0
f,f,1931,3035,429098,154443,12317,29711,89425,285896
f,m,1709,0,0,0,0,0,0,0
f,m,1857,1583,251202,36927,3087,11346,31265,82625
u,u,1729,0,0,0,0,0,0,0
u,f,1899,3149,98457,13528,1223,3611,3500,21862
u,u,1991,25507,436061,136192,9268,28089,29388,202937
m,f,1739,75,1540,670,74,248,537,1529
u,u,1884,230,4869,671,101,218,106,1096
f,u,1969,13596,1131355,414067,33108,82127,236663,765965
m,f,1844,1302,194790,28761,2371,8589,20942,60663
m,f,1769,0,0,0,0,0,0,0
u,f,1922,3414,96638,17682,1472,3920,4070,27144
f,m,1726,15,0,13,13,4,18,48
f,m,1958,5486,557340,209260,15094,39124,102700,366178
u,m,1721,0,0,0,0,0,0,0
u,m,1980,12594,275761,71701,4512,13554,15577,105344
m,m,1819,825,102623,10791,871,3141,9404,24207
m,u,1735,0,0,0,0,0,0,0
u,f,1866,1143,41050,3428,417,1076,849,5770
u,u,1745,0,0,0,0,0,0,0
m,u,1714,0,0,0,0,0,0,0
u,m,1797,98,1763,139,9,86,37,271
f,m,1713,0,0,0,0,0,0,0
u,u,1779,31,506,103,10,39,17,169
u,f,1765,0,0,0,0,0,0,0
f,m,1943,4013,440146,146337,10528,26797,70369,254031
f,m,1737,0,0,0,0,0,0,0
u,m,1957,8489,174637,43417,2937,8366,8451,63171
u,f,1739,85,927,171,15,100,34,320
f,u,1816,129,15685,2150,254,781,2071,5256
m,f,1843,897,125070,18763,1446,5659,15325,41193
m,u,1941,11474,914416,318409,22178,63485,160130,564202
f,m,1963,6122,435991,198954,14446,37637,102969,354006
f,f,1893,3964,925593,167559,15035,37524,110968,331086
f,m,1707,0,0,0,0,0,0,0
f,m,1912,4962,913340,184739,14561,40122,106405,345827
m,u,1787,17,127,189,27,77,129,422
f,m,1856,1445,216224,32139,2870,9768,24670,69447
f,f,1754,0,0,0,0,0,0,0
u,f,1828,170,5477,545,37,199,115,896
m,m,1881,5826,873221,143386,12609,35761,83067,274823
f,f,1775,13,59,246,26,107,328,707
u,u,1755,0,0,0,0,0,0,0
f,u,1807,38,3832,924,123,349,1071,2467
u,f,1717,0,0,0,0,0,0,0
f,m,1743,0,0,0,0,0,0,0
m,f,2013,0,0,0,0,0,0,0
m,m,1958,17476,1823336,644683,42037,109747,273013,1069480
m,m,1808,335,48266,6914,601,2292,7273,17080
m,u,1818,126,9905,1826,179,609,1880,4494
m,f,1822,617,102815,20596,1639,5962,15757,43954
u,f,1771,63,1395,134,12,41,31,218
u,m,1997,13438,210296,65919,4485,13359,15555,99318
u,m,1860,1554,58307,4945,351,1585,1056,7937
m,f,1757,0,0,0,0,0,0,0
m,f,1766,6,46,76,4,19,35,134
m,m,1811,448,43042,8508,634,2705,6910,18757
u,f,1709,0,0,0,0,0,0,0
m,f,1969,5898,525769,193493,13749,34589,85148,326979
u,f,1740,0,0,0,0,0,0,0
u,u,1966,20326,412325,109782,7302,23058,23312,163454
u,m,1970,12874,236369,70620,4391,12705,14299,102015
u,u,1950,15785,405381,89004,5777,18654,17148,130583
f,f,1756,0,0,0,0,0,0,0
f,f,1742,0,0,0,0,0,0,0
u,u,1752,13,0,27,3,7,2,39
u,f,1983,3838,86766,24746,1516,4465,5785,36512
u,u,1895,700,16179,2567,224,786,614,4191
m,m,1970,25816,1972801,773264,50309,130593,335076,1289242
m,f,1940,4781,495038,155907,11005,29712,68863,265487
f,u,1734,0,0,0,0,0,0,0
m,f,1830,787,116640,15616,1340,4395,12652,34003
u,f,1993,5021,111403,35841,2434,6090,8663,53028
u,m,1742,44,579,57,3,19,10,89
u,m,1728,62,0,138,14,36,22,210
m,u,1903,3455,393826,74612,5743,17945,40131,138431
f,u,1713,0,0,0,0,0,0,0
m,m,1725,0,0,0,0,0,0,0
f,f,1859,945,171804,28967,2552,7549,25157,64225
f,u,1831,105,13257,1972,253,575,1932,4732
m,f,1994,11927,820598,385409,25288,68226,178701,657624
u,u,1723,0,0,0,0,0,0,0
m,u,1796,9,92,24,2,10,25,61
f,f,1728,0,0,0,0,0,0,0
f,u,1959,6990,559735,202068,15569,40621,117640,375898
f,m,1769,5,0,0,0,0,1,1
m,m,1955,19962,1922231,708347,47054,119988,307861,1183250
f,u,1840,87,7872,856,80,323,1064,2323
m,m,1901,10826,1453616,267098,19774,63193,152757,502822
u,u,1970,25534,462696,125041,8906,27593,25113,186653
m,f,1874,2346,354573,62444,5594,15812,34457,118307
f,m,1968,7694,640593,264536,19809,49646,137381,471372
f,u,1837,84,20450,1620,88,509,1227,3444
m,f,1975,6330,439988,175060,13415,34214,77371,300060
u,f,1883,2208,57139,7691,779,2293,2017,12780
m,u,1997,32841,1609257,740989,53114,143687,362251,1300041
f,u,1717,0,0,0,0,0,0,0
m,m,1884,7463,831065,160453,14148,40739,95597,310937
u,u,2010,1075,10242,4843,347,1026,836,7052
m,m,2002,19724,1256074,592079,36716,98348,269872,997015
m,m,2000,24430,1554190,733882,47502,124952,337607,1243943
u,f,1875,1479,31806,5672,550,1576,1596,9394
m,u,1779,10,848,259,11,80,313,663
u,f,1896,4210,167408,20322,1536,5614,4292,31764
f,u,1798,0,0,0,0,0,0,0
f,u,1760,16,159,252,34,112,352,750
m,f,1713,0,0,0,0,0,0,0
u,m,1882,3448,78608,10500,1013,3212,2779,17504
m,f,1913,6943,978434,198943,15344,42959,103961,361207
u,u,1907,1611,36861,6337,466,1485,1239,9527
u,m,1951,9257,234038,53623,3556,10556,9402,77137
u,f,2011,0,0,0,0,0,0,0
m,u,1948,21700,1536569,585040,43284,115189,283569,1027082
m,f,1720,0,0,0,0,0,0,0
f,u,1964,8051,710165,281216,20824,53784,154193,510017
u,m,1911,6020,158815,22190,1712,5811,4864,34577
u,f,1730,0,0,0,0,0,0,0
m,f,1872,2825,384462,65152,6173,16549,39745,127619
f,f,1994,6518,702573,379339,23269,59055,200586,662249
u,u,2002,20421,316713,98703,6815,18989,22696,147203
m,m,1854,3798,433460,60254,5072,17564,43863,126753
m,f,1894,5702,780636,141298,12387,33961,81831,269477
m,f,1963,5043,478389,182490,12876,32915,78806,307087
f,m,1852,1468,284967,35824,3245,11138,29212,79419
f,u,1900,9647,1408704,329056,27345,79972,227807,664180
f,f,1939,2198,304536,111357,7984,19636,57211,196188
m,f,1772,36,1124,206,16,64,162,448
u,f,1722,124,624,302,27,143,51,523
m,m,1885,7555,901789,154782,13670,39135,92579,300166
m,f,1827,1287,196748,29328,2073,8944,21390,61735
m,m,1754,28,79,60,8,19,37,124
u,m,1829,1910,89260,5197,451,1743,1208,8599
m,f,1716,0,0,0,0,0,0,0
m,m,1733,28,0,80,7,33,38,158
m,m,1775,0,0,0,0,0,0,0
u,f,1779,8,36,11,2,4,1,18
m,f,1743,67,0,809,73,351,576,1809
u,m,1927,8013,193684,35524,2657,8944,8013,55138
m,f,1790,0,0,0,0,0,0,0
f,u,1960,8727,745445,311540,22929,60104,167970,562543
m,u,1845,414,64725,6385,451,2039,5113,13988
f,f,1799,143,13547,2000,221,875,2861,5957
u,u,1793,17,132,10,1,9,1,21
m,m,1998,20513,1389340,623174,39109,104668,296267,1063218
f,m,1788,129,7003,871,75,367,918,2231
u,f,2013,0,0,0,0,0,0,0
u,m,1999,10593,204110,57226,3660,10801,12817,84504
m,f,1793,68,14020,1985,137,664,1799,4585
u,m,1842,1106,53879,4286,320,1538,796,6940
u,m,1785,211,3097,480,49,262,147,938
u,m,1714,0,0,0,0,0,0,0
f,f,1750,0,0,0,0,0,0,0
f,u,1908,1481,211421,42655,3149,9577,27626,83007
u,u,1976,20593,319350,91591,6767,19825,19350,137533
u,f,1834,438,16563,1383,111,470,322,2286
f,f,1765,0,0,0,0,0,0,0
u,m,1861,851,25254,2520,224,701,466,3911
f,u,1945,5485,531997,185251,13694,32940,96333,328218
u,u,1962,19750,409978,108099,6983,24459,20596,160137
m,u,1970,39184,2206783,848466,65177,176148,441948,1531739
m,f,1891,4970,690150,125793,11345,30205,72408,239751
f,f,1909,3207,715896,132224,10198,28092,81270,251784
u,f,1715,0,0,0,0,0,0,0
m,u,1924,11255,725943,252054,19857,53577,135366,460854
f,m,1763,54,3685,501,56,245,499,1301
u,m,1719,4,0,0,0,2,0,2
m,m,1986,22256,1817861,696567,43834,116104,309337,1165842
u,m,1752,82,348,170,10,74,30,284
m,m,1817,277,25433,4816,356,1362,3128,9662
m,u,1897,813,89555,15702,1241,3618,9631,30192
u,f,1801,104,1310,259,24,79,71,433
f,f,1725,0,0,0,0,0,0,0
u,u,1873,221,1259,243,41,98,62,444
f,u,1916,1612,265995,53730,3952,12402,30738,100822
m,m,1749,137,9331,2368,191,792,1565,4916
m,f,1828,454,101560,12816,1062,4138,9634,27650
u,u,1899,808,27815,3480,250,758,628,5116
f,f,1747,0,0,0,0,0,0,0
m,f,1746,0,0,0,0,0,0,0
u,u,1913,2582,65450,11536,920,3064,2133,17653
u,f,1733,0,0,0,0,0,0,0
u,f,1852,562,29124,3178,241,675,896,4990
u,f,1799,111,1599,214,24,79,70,387
u,u,1924,7965,140799,32630,2372,8276,6482,49760
u,f,2009,2942,34810,20395,1235,3837,4592,30059
u,m,1969,13642,232323,61737,4265,12399,11632,90033
f,f,2000,6128,719397,370223,24606,59394,197452,651675
f,f,1823,291,74471,13114,1180,4501,11177,29972
f,f,1947,3504,496938,177130,13084,29738,88979,308931
u,u,1939,7590,191571,37427,2692,8270,7937,56326
f,m,1913,4947,910654,184249,14161,40106,110044,348560
f,u,1824,79,12647,3542,324,1293,3192,8351
u,u,1769,10,127,28,5,10,5,48
u,u,2001,18737,315167,104217,7124,21253,23721,156315
m,m,1763,163,2625,1163,102,423,977,2665
u,u,1778,0,0,0,0,0,0,0
u,m,1800,69,780,116,12,63,14,205
m,f,1773,0,0,0,0,0,0,0
f,u,1797,0,0,0,0,0,0,0
m,u,1730,0,0,0,0,0,0,0
m,f,1792,77,6179,2104,165,608,1948,4825
u,f,1741,0,0,0,0,0,0,0
f,m,1956,5588,617481,219068,14937,38706,111128,383839
u,f,1968,2818,52418,15758,1051,3191,3402,23402
f,u,1770,0,0,0,0,0,0,0
m,u,1836,187,14629,2502,262,783,2475,6022
f,f,1921,3152,828728,186316,14172,36566,108754,345808
f,f,1812,356,82106,14215,1281,5020,12626,33142
f,f,1733,0,0,0,0,0,0,0
u,m,2002,10305,155892,54625,3555,9884,10965,79029
m,f,1715,0,0,0,0,0,0,0
u,u,1763,0,0,0,0,0,0,0
f,f,1829,577,126956,19111,1645,5767,18105,44628
f,f,1988,6610,933914,369013,23267,58707,194844,645831
f,f,1743,30,674,751,63,407,574,1795
m,f,1931,5564,598539,203941,16173,40443,99026,359583
u,f,1846,409,12512,1335,127,471,309,2242
m,f,1816,488,94371,15326,1073,4905,10563,31867
f,u,1721,0,0,0,0,0,0,0
m,u,1904,2934,259562,58469,4876,13963,30465,107773
f,f,1711,0,0,0,0,0,0,0
m,f,1808,96,11323,1301,130,486,1420,3337
m,m,1731,0,0,0,0,0,0,0
m,f,1846,907,121250,20590,1844,5540,15091,43065
m,u,1896,1130,133843,23346,1884,5672,12258,43160
m,m,1722,52,1164,235,26,103,114,478
u,u,1881,372,5713,919,100,284,229,1532
m,m,1796,481,42452,7528,601,2652,7650,18431
u,m,1943,7145,146732,34365,2403,7379,5836,49983
u,m,1803,147,2368,286,26,109,62,483
u,m,1838,640,23024,1953,160,655,365,3133
m,u,1799,0,0,0,0,0,0,0
u,m,1885,4334,124194,14343,1149,4122,2946,22560
f,m,1891,3108,530635,98805,8478,23295,66163,196741
f,f,1720,0,0,0,0,0,0,0
m,m,1909,12418,1801972,326418,23621,73910,172381,596330
u,m,1713,0,0,0,0,0,0,0
f,f,1943,2867,471587,154932,10729,25798,73666,265125
u,u,1973,17604,292284,86409,6192,18266,18157,129024
f,f,1811,120,37586,7987,563,2586,7257,18393
m,u,2010,1548,66646,31898,2446,6576,15802,56722
m,m,1757,0,0,0,0,0,0,0
f,u,1795,21,896,238,31,127,337,733
m,m,1956,18986,1755766,623745,40625,104085,271499,1039954
u,m,1856,1498,55702,4576,413,1469,963,7421
m,u,1991,38483,1732117,835834,60981,159361,412501,1468677
u,m,1840,1856,38220,3935,341,1557,703,6536
m,m,1783,12,196,35,0,19,48,102
m,f,1957,5464,512218,193930,14437,35261,80572,324200
u,u,1846,227,12569,707,56,266,94,1123
u,u,1843,199,11347,1072,86,404,230,1792
u,f,1720,0,0,0,0,0,0,0
m,m,1907,11839,1534809,305105,22363,69180,162640,559288
m,m,1961,21162,1903978,687913,45755,116032,296644,1146344
u,u,1979,19820,396061,105909,7069,21740,21793,156511
f,u,1740,0,0,0,0,0,0,0
f,m,1746,0,0,0,0,0,0,0
u,f,1734,0,0,0,0,0,0,0
m,m,1769,52,1127,160,9,63,69,301
m,f,1958,5342,508516,168784,12363,30159,73152,284458
u,f,1912,3011,76180,11912,951,3098,2766,18727
f,u,1759,0,0,0,0,0,0,0
f,u,1820,47,12482,1651,146,530,1023,3350
u,f,1703,0,0,0,0,0,0,0
f,m,1906,3760,584078,127534,9501,28171,79143,244349
m,u,1738,0,0,0,0,0,0,0
u,m,1964,11081,204794,58467,4047,11645,11314,85473
f,m,1836,772,128576,14018,1207,4353,13258,32836
f,f,1855,1218,336820,52524,4356,13737,44883,115500
m,u,1980,29575,1584844,710023,49983,129553,341902,1231461
f,f,1868,1475,346489,64591,5484,15801,48307,134183
m,m,1801,541,48842,7714,675,2731,6195,17315
m,u,1916,4668,447060,98658,7144,23350,47932,177084
m,m,1913,14634,2232778,432797,30420,93606,214532,771355
u,m,1820,348,13187,1416,109,377,277,2179
f,f,1824,433,133540,20672,1738,6460,17848,46718
f,m,1884,2589,409246,87721,8043,21593,59761,177118
u,f,1917,2872,99086,15018,1069,3373,3189,22649
m,m,1836,2343,282681,31170,2516,9321,25098,68105
f,u,1761,0,0,0,0,0,0,0
m,m,1893,13293,1899888,323080,25283,81672,179911,609946
u,f,1798,105,1520,332,49,143,84,608
m,f,1912,6158,810839,163173,12499,34985,87073,297730
m,f,1856,2320,369247,55342,5214,14542,38023,113121
f,m,1892,3617,566191,113053,9752,28127,76355,227287
m,m,1921,15074,2095518,484606,34738,100981,253427,873752
u,u,1981,21288,368393,105580,7159,21353,24223,158315
f,f,1881,2319,492093,93969,8361,22346,66354,191030
m,m,1753,16,19,64,4,48,61,177
u,m,1949,8199,158591,37696,2494,7617,7786,55593
f,m,1715,3,0,4,2,3,3,12
u,m,1824,688,15277,1307,112,549,304,2272
m,u,1890,989,82617,16656,1507,4197,10215,32575
m,m,1716,0,0,0,0,0,0,0
u,u,1985,21811,370651,117694,8048,24343,26472,176557
u,u,1797,0,0,0,0,0,0,0
u,f,1763,0,0,0,0,0,0,0
f,u,1941,4339,507280,164285,11938,28810,89825,294858
m,u,1729,0,0,0,0,0,0,0
m,m,1743,0,0,0,0,0,0,0
m,u,1736,0,0,0,0,0,0,0
m,f,2007,12366,754506,413520,28625,74446,193688,710279
u,m,1880,3235,98493,10419,886,3079,2681,17065
f,u,1788,15,185,114,16,55,163,348
f,u,1934,4114,332348,136518,11487,27705,77710,253420
f,u,1845,165,22973,2561,214,739,2106,5620
f,m,1757,0,0,0,0,0,0,0
f,u,1841,63,6884,1557,116,443,1310,3426
f,f,1796,48,1970,668,63,255,629,1615
f,m,1934,4971,575558,195406,16124,39443,108621,359594
f,f,1805,69,11527,3375,210,1354,3296,8235
m,m,1708,91,302,1342,125,496,776,2739
f,u,1719,0,0,0,0,0,0,0
f,u,1709,0,0,0,0,0,0,0
u,u,1822,258,4958,512,37,233,217,999
u,f,1822,228,5700,833,77,301,272,1483
u,m,1764,145,2653,508,58,188,62,816
f,u,1999,12985,778035,388545,27694,70812,224791,711842
f,f,1917,3678,834526,165690,12830,33590,96633,308743
m,m,1943,14365,1444470,467179,31603,77626,195946,772354
f,m,1863,717,110691,18946,1873,5432,14877,41128
m,u,1783,0,0,0,0,0,0,0
u,f,1847,563,13221,1300,109,448,287,2144
m,m,1872,7274,1085928,140704,11567,38796,84872,275939
f,m,1830,633,108653,13445,1129,4642,14155,33371
u,u,1886,461,12371,1191,140,403,306,2040
f,f,1816,266,97949,12396,956,4299,10485,28136
m,m,1859,5064,696897,89002,7645,24611,64133,185391
u,f,1945,2545,76336,17892,1267,3632,3603,26394
m,f,1777,0,0,0,0,0,0,0
m,f,1712,0,0,0,0,0,0,0
f,u,2000,12701,857516,371359,26176,70018,213419,680972
m,u,1705,0,0,0,0,0,0,0
m,u,1932,13083,954428,319713,23524,65458,168323,577018
f,f,2013,0,0,0,0,0,0,0
f,u,1853,305,52368,8364,705,2427,6792,18288
m,m,1728,35,7385,414,42,120,208,784
f,f,1961,2465,354567,131562,9076,21667,65886,228191
m,m,1918,11714,1556113,333207,24630,69727,166771,594335
m,m,1939,12586,1259266,394275,26887,71198,179897,672257
u,u,1718,0,0,0,0,0,0,0
m,m,1892,11485,1352792,249661,21265,61032,145119,477077
f,f,1769,0,0,0,0,0,0,0
f,m,1896,5408,687361,131160,11369,32406,86278,261213
f,m,1731,0,0,0,0,0,0,0
f,m,1975,5712,502214,200690,13182,36031,103032,352935
f,u,1801,11,583,170,24,55,186,435
m,u,2005,31180,1513615,725892,51390,139004,354628,1270914
u,m,1961,11239,207140,57252,3645,10957,11022,82876
f,f,1828,282,66833,10507,862,3448,9627,24444
u,m,1778,0,0,0,0,0,0,0
u,u,1783,0,0,0,0,0,0,0
m,f,1906,5374,737081,149492,11138,32966,82624,276220
m,f,1764,0,0,0,0,0,0,0
u,u,1929,14962,278656,63608,4520,15860,12949,96937
m,m,1868,3216,482537,84331,7035,22723,49164,163253
f,u,1892,451,53868,12718,1091,3269,10239,27317
f,m,1704,0,0,0,0,0,0,0
u,u,1992,26336,511855,145387,10499,30266,32656,218808
f,f,1913,4337,939606,183343,13445,37333,115191,349312
f,m,1780,18,679,49,2,19,45,115
f,m,1720,0,0,0,0,0,0,0
u,f,1769,0,0,0,0,0,0,0
f,u,1839,251,47325,5893,501,1869,5334,13597
u,m,1899,12276,394358,49080,4087,13472,12165,78804
f,m,1875,916,207965,38789,3434,10154,27231,79608
m,u,1850,51,5744,563,45,147,438,1193
f,m,1710,0,0,0,0,0,0,0
f,f,1773,0,0,0,0,0,0,0
u,m,1948,7741,187696,40591,2716,8151,8504,59962
m,u,1867,637,76002,13992,1063,3739,9293,28087
f,u,1774,1,0,1,0,0,0,1
m,m,1928,15408,1489899,454910,33064,91325,232703,812002
f,u,1992,15464,975792,497672,36275,90795,279581,904323
m,f,1892,5238,683019,130871,12133,30932,76354,250290
f,m,1827,460,56630,7985,836,2897,8129,19847
u,m,1826,950,33405,2382,159,777,726,4044
f,f,1808,66,11674,1608,141,577,1717,4043
f,f,1768,0,0,0,0,0,0,0
m,u,1935,13572,1143990,381855,29077,73243,194642,678817
u,u,1761,0,0,0,0,0,0,0
u,f,1891,2373,69483,8260,732,2399,1991,13382
u,m,1866,2309,81804,7597,710,2393,1477,12177
u,u,1816,76,2033,132,19,52,36,239
u,u,1967,25734,401736,116912,8291,27821,24116,177140
f,u,1803,80,10322,1313,122,495,1389,3319
f,f,1998,6134,610120,322774,21475,52788,179769,576806
m,u,1820,141,18077,2703,229,756,2037,5725
m,u,1974,23786,1258491,560005,41020,109233,266003,976261
u,f,1723,0,0,0,0,0,0,0
u,f,1814,364,3913,1305,93,483,315,2196
m,u,1716,0,0,0,0,0,0,0
f,m,1995,6472,610516,261131,16520,44401,138844,460896
f,m,1850,1481,410464,53699,4105,16421,45710,119935
m,m,1917,11370,1467875,327761,23195,68662,167088,586706
f,f,1932,2281,337259,141371,10465,25714,79554,257104
u,u,1878,284,9990,914,91,235,229,1469
u,u,1927,9497,141481,34884,2816,9550,6807,54057
m,f,1763,0,0,0,0,0,0,0
u,m,1754,40,0,69,9,21,23,122
u,f,1930,2308,43180,14348,1152,3327,3288,22115
m,u,1827,352,41543,5948,587,1666,4246,12447
m,f,1893,6517,841039,165353,14682,39513,92448,311996
u,u,1999,20455,346713,112198,7605,22863,27108,169774
f,f,1832,726,141228,20393,1995,6142,17502,46032
u,m,1759,87,887,155,15,77,8,255
m,f,1719,38,4814,469,49,237,352,1107
u,m,1965,12412,248209,67428,4196,13265,12604,97493
u,u,1855,349,5859,884,93,299,253,1529
f,u,1987,11074,736515,337860,26072,62697,182859,609488
f,u,1863,326,69882,11286,1057,2767,8797,23907
m,m,1903,10075,1252023,246906,18961,58616,134493,458976
u,m,1821,357,16643,1206,78,374,240,1898
f,u,1814,16,10178,1501,113,407,1326,3347
u,u,1974,15277,275256,75313,5367,15947,15033,111660
u,m,1739,188,3037,487,35,238,55,815
u,f,1859,493,10234,1688,110,438,346,2582
u,f,1895,2730,70887,8983,871,2612,2162,14628
f,m,1764,26,943,90,6,69,90,255
m,u,1841,203,21885,4491,324,1408,2899,9122
m,m,1927,15820,1695164,501230,37251,103617,260374,902472
f,f,1981,4440,641692,264920,17343,43736,139617,465616
m,f,1704,0,0,0,0,0,0,0
f,u,1925,4311,478131,161941,12226,35578,103743,313488
m,u,1939,11173,956503,304795,20704,57212,149196,531907
f,u,1912,2053,234150,51291,3995,12084,33868,101238
m,f,1809,453,78383,12775,1083,4156,9333,27347
m,f,1875,3215,424526,91864,7955,22988,55178,177985
m,f,1710,0,0,0,0,0,0,0
m,m,1774,99,12045,1690,150,504,1385,3729
m,m,1773,19,1748,727,38,199,596,1560
f,m,1792,46,1247,422,51,162,465,1100
m,f,1956,5713,605328,204408,15172,37317,88446,345343
m,m,1800,148,29705,4550,341,1418,3135,9444
m,u,1998,31218,1410685,688747,50440,133453,346906,1219546
f,f,1928,2761,389789,138792,10464,25540,79414,254210
m,f,1980,8536,715545,280444,20115,51176,131086,482821
u,m,1883,5597,123198,13191,1209,4124,3145,21669
f,m,1908,3717,594639,131095,10270,29971,80321,251657
m,m,1736,180,10500,2699,219,1187,2286,6391
u,f,1790,0,0,0,0,0,0,0
f,m,1941,3798,404906,144352,10511,26970,76238,258071
f,u,1869,184,40586,6645,597,1701,6037,14980
u,m,1939,6413,148699,30481,2153,6453,6371,45458
m,u,1789,44,531,415,58,157,421,1051
f,m,1793,26,6544,1156,99,476,870,2601
m,m,1810,575,39430,11788,1074,3799,9320,25981
u,m,1740,109,3676,188,7,101,33,329
f,u,1921,1580,285928,56981,4420,13149,29612,104162
u,f,1951,2899,62023,16307,1205,3404,3079,23995
f,m,1864,1269,237785,40020,3706,11663,30157,85546
m,m,1920,15306,1940710,450552,32782,96164,223094,802592
f,f,1927,2524,381781,135301,10496,25555,78923,250275
f,f,1906,2935,633055,126615,9910,25685,80572,242782
m,m,1968,25005,1955722,783539,52768,134094,339955,1310356
m,f,1779,19,1120,338,50,116,216,720
f,f,1895,2964,633168,122468,10299,26303,81660,240730
f,f,1722,20,2080,217,19,143,201,580
m,m,1886,6811,873288,158509,13369,38929,92971,303778
m,f,1774,44,2201,420,45,153,173,791
m,m,1906,10915,1526224,289291,20839,63613,153423,527166
m,f,1722,46,4680,621,54,273,414,1362
u,f,1736,0,0,0,0,0,0,0
f,u,1733,0,0,0,0,0,0,0
u,m,1816,142,6743,394,50,157,88,689
f,m,1868,1133,153679,27827,2607,8313,21256,60003
u,f,1829,337,11888,941,99,339,286,1665
u,m,2013,16,0,181,23,63,41,308
m,u,1855,926,100761,17273,1605,4938,12019,35835
u,f,1991,4974,87993,30108,2286,5934,6990,45318
m,u,1923,14061,1068767,335818,24717,75909,188310,624754
f,u,1764,0,0,0,0,0,0,0
m,u,1776,0,0,0,0,0,0,0
f,f,1783,0,0,0,0,0,0,0
f,m,1748,2,0,0,0,3,0,3
m,u,1790,0,0,0,0,0,0,0
m,u,1834,520,61846,7746,596,2217,6286,16845
u,m,2012,0,0,0,0,0,0,0
u,u,1772,0,0,0,0,0,0,0
u,f,1937,2861,73213,18442,1422,3747,4010,27621
f,m,1805,30,590,296,42,119,289,746
m,m,1966,21534,1823612,712526,45650,119025,306966,1184167
u,u,1851,205,7022,498,33,163,120,814
f,f,1896,3553,733162,127176,11188,28343,87142,253849
f,u,1777,0,0,0,0,0,0,0
m,u,1762,0,0,0,0,0,0,0
f,m,1806,112,9816,1784,158,581,2129,4652
f,u,1899,468,81506,13567,1053,3273,9309,27202
m,u,1824,191,16067,3729,320,1087,2437,7573
m,m,1855,3075,421225,59643,4468,16431,38570,119112
m,m,1950,19279,2277305,700658,44824,118826,318687,1182995
u,u,1874,146,1959,236,37,86,92,451
u,u,1853,226,7686,805,56,268,122,1251
m,u,1801,27,5024,798,80,274,565,1717
f,u,1852,213,47172,6725,540,2016,5029,14310
m,m,1824,1482,131257,22825,1820,7199,18506,50350
m,m,1931,12502,1354706,414357,27577,78613,198999,719546
f,f,1813,410,69483,11315,803,4020,14119,30257
f,f,1836,709,162753,23577,2083,7330,22424,55414
m,u,1891,1004,107124,20983,1857,5421,13663,41924
u,u,1833,84,5202,247,24,122,91,484
f,m,1937,5417,607669,216452,16433,39374,107777,380036
f,u,1731,0,0,0,0,0,0,0
f,f,1851,771,211170,33000,3026,9485,30162,75673
f,f,1800,184,32416,6557,678,2156,6144,15535
f,m,1952,5956,673761,236742,17197,43520,119013,416472
m,f,1934,6285,529829,194839,15341,39049,94605,343834
u,u,1960,16870,385607,96344,5996,19928,19380,141648
f,f,1736,0,0,0,0,0,0,0
f,f,1842,563,129621,21311,1927,6192,18681,48111
f,u,1794,47,8200,1863,198,681,1965,4707
f,m,1760,10,29,55,9,48,93,205
f,u,1893,437,64492,13171,1195,2901,9681,26948
u,f,1714,0,0,0,0,0,0,0
u,f,1839,496,14660,1716,127,621,452,2916
m,u,1746,0,0,0,0,0,0,0
u,f,1976,3142,77761,22427,1465,4208,4790,32890
u,f,1914,2945,90612,13319,980,3187,2981,20467
f,f,1810,338,58023,13213,1021,4859,13872,32965
f,m,1787,23,1114,172,16,97,229,514
u,f,1861,579,13670,1709,192,589,425,2915
f,m,2006,6625,404638,237481,15908,40417,127030,420836
f,m,2007,6719,471889,262203,17793,45450,137933,463379
u,m,1827,557,19579,1799,247,588,433,3067
m,f,1864,2550,386988,60096,5258,16046,36508,117908
m,m,1703,141,13104,1423,113,672,1215,3423
u,m,1988,14664,353680,84684,5073,15356,18789,123902
u,m,1715,22,0,17,4,10,3,34
u,f,1800,93,2184,266,32,108,52,458
f,u,1844,135,22813,4484,294,1334,4267,10379
u,u,1722,20,0,21,3,16,0,40
f,m,1855,1004,177987,25866,2231,7983,18902,54982
u,u,1948,12771,262875,62512,4476,14229,11835,93052
u,f,1752,0,0,0,0,0,0,0
u,m,1704,0,0,0,0,0,0,0
m,f,1880,3853,433061,94822,8471,23976,57526,184795
u,u,1942,7682,124701,35051,2576,7603,7172,52402
m,f,1868,2454,348353,68275,5967,17250,40473,131965
u,u,1877,185,5776,387,62,125,82,656
u,f,1743,119,2743,363,33,195,27,618
u,f,1931,2954,63155,18461,1428,4209,4140,28238
u,u,2013,0,0,0,0,0,0,0
f,f,1704,0,0,0,0,0,0,0
u,u,1705,0,0,0,0,0,0,0
u,m,1747,0,0,0,0,0,0,0
f,f,2010,3,0,124,2,17,66,209
f,m,1777,15,0,209,35,79,208,531
u,m,1709,0,0,0,0,0,0,0
u,f,1901,2604,65585,9556,724,2534,2181,14995
m,m,1959,18923,1864322,624012,39841,104944,275156,1043953
m,f,1736,0,0,0,0,0,0,0
u,u,1908,3267,44976,7932,715,1914,2285,12846
f,f,1918,3350,700675,152232,11736,31109,89387,284464
m,u,1795,44,2979,412,53,203,403,1071
f,f,1966,2673,301022,118403,8661,20198,56155,203417
f,m,1721,0,0,0,0,0,0,0
m,f,1896,7359,935361,158078,13619,38313,92196,302206
f,m,1765,0,0,0,0,0,0,0
u,u,1837,116,7633,572,55,194,75,896
f,u,1907,880,109853,22914,1962,5663,13926,44465
u,f,1713,0,0,0,0,0,0,0
u,m,1830,1100,39439,3013,284,1217,651,5165
f,u,1914,1344,187695,33838,2622,8612,21182,66254
m,f,1806,276,24580,6954,510,2253,6026,15743
u,m,1741,16,0,15,1,8,7,31
m,m,1940,13922,1624330,513016,33469,88283,223405,858173
u,f,1840,518,18335,1699,156,533,411,2799
m,m,1829,4431,678530,65299,5210,18691,55299,144499
m,f,1780,0,0,0,0,0,0,0
f,f,1741,0,0,0,0,0,0,0
u,m,1855,1253,37160,3947,280,1189,828,6244
f,u,1894,341,49813,12714,951,2520,8780,24965
m,m,1848,3049,448239,57364,4442,16217,41512,119535
m,f,1937,6050,575439,194095,14547,36874,89449,334965
f,u,1729,0,0,0,0,0,0,0
u,u,1987,20425,327759,107253,7412,22144,23671,160480
u,u,1785,8,13,40,9,9,9,67
u,u,1940,7644,174290,46829,3197,10372,8782,69180
f,f,1904,2242,454268,80839,5837,17214,53007,156897
f,u,1802,53,7833,1100,81,394,1224,2799
m,f,1760,0,0,0,0,0,0,0
u,u,1914,2027,54788,7738,594,2003,1632,11967
u,m,1904,5144,113837,18787,1489,5244,3607,29127
u,m,1973,11191,208411,53355,3554,10427,11410,78746
f,u,1711,0,0,0,0,0,0,0
u,u,2004,20225,319394,106672,7818,22743,25236,162469
m,u,1812,93,11828,1978,191,643,1794,4606
m,f,1974,5671,451837,181154,13542,34246,85203,314145
m,u,1823,81,7314,1336,153,396,1146,3031
m,f,1966,5208,505229,177389,12701,31384,75667,297141
f,f,1703,0,0,0,0,0,0,0
f,f,1973,3035,288464,148944,10927,26669,74532,261072
f,u,1878,218,29420,6314,540,1560,4838,13252
m,f,1927,4215,432649,139587,11664,29453,70852,251556
u,f,1856,893,21216,2793,267,823,795,4678
f,m,1723,0,0,0,0,0,0,0
u,u,1735,0,0,0,0,0,0,0
m,f,1995,10818,708733,338172,23414,61036,154470,577092
f,u,2004,11108,630537,328824,24011,60659,189382,602876
m,f,1850,1291,213168,30835,2540,8326,21782,63483
m,m,1932,14479,1532209,489941,36222,94283,229627,850073
m,f,1921,4898,682421,166072,12909,35754,80931,295666
m,m,1704,0,0,0,0,0,0,0
u,f,1786,27,240,32,1,6,1,40
m,f,1745,0,0,0,0,0,0,0
u,u,1858,793,19996,2063,178,637,606,3484
u,u,1906,1168,29680,4477,367,1230,976,7050
m,m,1813,125,6530,974,73,399,500,1946
u,f,1908,2542,70289,9752,735,2330,2176,14993
m,u,1802,57,8322,1282,102,438,1100,2922
u,f,1864,1216,42283,4178,378,1328,1021,6905
f,u,1994,15349,1023098,494799,36248,90568,277203,898818
m,u,1831,303,26813,4925,469,1536,4102,11032
f,f,1924,1985,309436,98146,7711,18836,60801,185494
m,u,1747,0,0,0,0,0,0,0
f,m,1719,5,0,12,3,18,31,64
u,u,1932,9671,230290,48377,2988,10951,10331,72647
f,m,1736,142,3937,1149,104,774,1734,3761
m,f,1753,35,803,617,63,247,379,1306
f,u,1757,0,0,0,0,0,0,0
m,u,1819,169,29894,4306,330,1552,3170,9358
m,m,1977,20187,1661253,650327,40752,105980,290924,1087983
m,u,1750,0,0,0,0,0,0,0
m,f,1765,0,0,0,0,0,0,0
f,f,1903,2396,496061,97114,7403,20535,63770,188822
f,f,1864,1373,359293,59991,5124,15025,45214,125354
m,m,1706,0,0,0,0,0,0,0
f,u,1727,0,0,0,0,0,0,0
u,m,1929,9293,160432,37651,2763,9437,7439,57290
f,m,1895,4450,726524,136583,11596,32645,86613,267437
m,m,1804,470,32269,6224,575,2166,5061,14026
m,m,1947,22255,2078435,680320,47948,119421,312300,1159989
f,f,1940,2336,409410,138821,9655,23435,66898,238809
f,f,1938,3625,645289,233869,16392,40036,134294,424591
u,f,2001,5513,113130,31767,2181,6522,7918,48388
m,u,1813,25,3094,836,101,250,588,1775
f,u,1911,1337,179987,32820,2778,7906,20144,63648
f,f,1848,661,213938,28413,2684,7888,25067,64052
m,u,1782,0,0,0,0,0,0,0
f,u,1953,7068,571875,209634,15134,39171,111167,375106
f,u,1967,11725,1020241,408390,30878,80514,234214,753996
u,u,1823,30,355,123,8,28,17,176
u,u,1808,36,347,76,11,23,20,130
u,f,1880,2828,104041,13880,1024,4122,3447,22473
u,m,1919,6652,155855,27080,2187,6643,5970,41880
f,u,1793,17,513,583,29,193,760,1565
u,u,1885,351,9495,1110,132,329,318,1889
u,m,1848,1452,43649,3934,325,1449,865,6573
m,f,1908,5474,721992,142965,11012,30972,72004,256953
u,f,1926,1953,32878,8747,702,2199,2167,13815
f,f,1948,3085,496111,180432,13420,30966,91980,316798
m,u,1843,376,72475,7955,556,2319,5778,16608
f,u,1873,292,56155,9973,985,2620,7037,20615
f,m,1842,647,153841,24477,1813,7378,19776,53444
u,f,1808,82,3157,348,21,143,34,546
m,u,1985,32670,1622477,726493,52919,135551,350360,1265323
f,f,1871,1422,360684,58635,5341,14145,43035,121156
m,f,1886,5379,706177,129801,11856,30773,77502,249932
f,m,1931,3974,464069,152535,11247,30544,84122,278448
u,m,1822,248,7991,512,45,170,114,841
f,m,1974,6267,426779,182142,13114,33781,93153,322190
f,f,1787,60,6318,899,84,499,1244,2726
f,m,1966,6829,579676,227803,16225,41605,118745,404378
f,f,1920,3976,863107,198664,15019,39322,115103,368108
f,m,1779,0,0,0,0,0,0,0
m,u,1732,3,0,5,1,3,0,9
m,m,1895,14423,1822581,322676,24845,79601,183498,610620
f,m,1927,5162,612431,202506,15353,42583,120819,381261
f,f,1971,2263,208343,96441,7167,16566,50734,170908
u,u,1842,117,1385,197,30,45,50,322
u,f,1758,30,24,25,3,10,14,52
f,m,1774,44,3055,421,50,152,464,1087
f,u,2006,12044,761794,412715,27554,69654,231698,741621
f,u,1827,176,29042,3958,439,1204,2884,8485
u,f,2007,5989,64306,29736,2241,6078,6762,44817
f,u,1976,11632,935559,359754,27454,70057,200427,657692
m,f,1900,5214,622124,121907,9530,27233,67792,226462
m,f,1902,4092,486987,94681,7575,21139,55353,178748
f,u,1861,155,19089,3277,249,1008,3576,8110
u,u,1916,2576,84096,12922,952,3627,2273,19774
m,f,1824,749,163675,23987,1964,7334,17090,50375
f,u,1854,362,78115,12317,1024,3224,9126,25691
m,u,1805,11,110,65,8,21,88,182
u,m,2011,70,7555,1332,20,259,226,1837
m,f,1990,12761,1078845,398843,28367,74649,184438,686297
u,m,1839,911,30480,2735,191,935,570,4431
m,m,1924,13558,1363149,437481,31863,86888,222951,779183
f,m,1957,5214,528878,193370,13106,35254,94021,335751
m,f,1717,0,0,0,0,0,0,0
m,f,1748,0,0,0,0,0,0,0
f,u,1995,13155,926417,393856,27973,74359,226960,723148
f,u,1975,10687,824603,347235,27278,71356,200209,646078
m,m,1983,20728,1875651,698898,43372,117403,308023,1167696
f,f,1748,0,0,0,0,0,0,0
f,u,1726,0,0,0,0,0,0,0
u,f,1789,0,0,0,0,0,0,0
m,u,1708,0,0,0,0,0,0,0
u,m,1933,8891,254572,45236,3286,9631,8545,66698
u,m,1913,6204,168890,24400,1858,6637,5407,38302
m,u,1811,131,17825,3845,284,1110,3548,8787
m,m,2012,0,0,0,0,0,0,0
m,u,1869,346,40046,8782,779,2191,6350,18102
m,m,1896,17945,1837741,345221,27380,84206,198771,655578
u,u,1725,17,0,52,6,16,10,84
m,m,1864,3722,572132,85960,7381,25017,54855,173213
f,f,1706,0,0,0,0,0,0,0
m,f,1703,0,0,0,0,0,0,0
f,m,1833,633,89077,10962,976,3607,10308,25853
u,f,1817,288,12983,1673,114,591,471,2849
u,f,1772,143,10942,671,68,236,168,1143
m,f,1996,12840,939974,389796,26182,68933,171232,656143
m,u,1742,0,0,0,0,0,0,0
f,u,1718,0,0,0,0,0,0,0
m,m,1938,12984,1282606,423529,29791,77802,196737,727859
u,m,1907,5490,158236,22059,1504,5869,4595,34027
f,m,1929,5628,611233,208962,16165,42788,118759,386674
f,u,1830,522,64947,6946,733,2386,7155,17220
m,f,1840,1140,186845,27086,2349,8764,21150,59349
u,u,1717,0,0,0,0,0,0,0
m,m,1831,3727,560581,56166,4265,16038,46054,122523
m,u,1826,173,8186,2795,194,1040,2153,6182
f,m,1851,673,115272,17417,1406,5543,13731,38097
m,u,1893,1170,113422,24918,2008,5971,14923,47820
m,m,1745,0,0,0,0,0,0,0
f,f,1818,442,76395,14142,1376,4675,12883,33076
m,f,1834,1113,217651,26511,2267,7935,17387,54100
f,u,2011,4,0,0,0,0,1,1
f,u,1730,0,0,0,0,0,0,0
m,m,1842,2161,440927,63893,4281,18551,42846,129571
u,u,1790,0,0,0,0,0,0,0
m,m,2001,20925,1188310,580549,37396,99622,269779,987346
u,m,1833,1090,45818,3467,277,1012,757,5513
f,m,1867,1066,207809,37181,3764,10184,26962,78091
m,m,1732,0,0,0,0,0,0,0
m,u,1863,530,79541,12179,1110,3017,7774,24080
f,m,1886,2465,494052,92582,8182,23177,63198,187139
m,f,1787,136,7252,1846,133,655,1457,4091
f,m,1861,529,95783,14641,1386,4190,11010,31227
u,f,1706,0,0,0,0,0,0,0
u,m,1766,3,0,2,0,1,3,6
f,u,1950,8055,916222,320986,25070,66231,184045,596332
m,u,1978,28644,1839788,710652,49232,133526,352710,1246120
u,u,1872,343,7488,873,79,288,253,1493
u,u,1891,600,14504,2388,221,647,601,3857
f,m,1880,2493,463707,69812,6096,17828,49185,142921
f,m,1900,3374,450812,94299,7604,22490,60376,184769
m,f,1941,6229,704300,219723,15198,40823,102279,378023
m,u,1817,136,8562,1882,194,706,1692,4474
m,m,1915,12174,1802190,363668,24975,76994,182110,647747
u,u,1713,0,0,0,0,0,0,0
u,f,1872,1133,34017,3404,334,1218,964,5920
f,u,1843,106,29208,3386,292,1144,3314,8136
m,u,2011,31,1795,34,8,23,0,65
u,u,1721,0,0,0,0,0,0,0
u,f,1832,478,16167,1176,117,453,352,2098
m,u,1969,38070,2429989,871687,65748,173716,448558,1559709
m,f,1848,990,183577,26362,2262,7124,17827,53575
u,f,1776,0,0,0,0,0,0,0
f,u,1856,345,80266,8901,779,2565,7596,19841
m,u,1953,21259,1422795,502420,35872,96508,246910,881710
f,m,1990,8854,904227,325606,20877,56879,167338,570700
f,f,1751,22,3117,1491,132,1064,1285,3972
m,m,2010,211,4497,3878,277,641,1745,6541
f,m,1985,6568,737463,260856,16493,44525,126696,448570
f,m,1717,0,0,0,0,0,0,0
f,f,1803,123,22452,3282,232,1277,3730,8521
f,f,1983,3397,437121,209682,14786,35054,105696,365218
f,m,1756,3,1070,138,15,82,113,348
m,m,1709,0,0,0,0,0,0,0
m,u,1830,1415,237543,24984,2187,8284,20414,55869
u,m,1979,12475,245117,65928,4183,12380,14839,97330
u,u,1734,0,0,0,0,0,0,0
f,m,1837,621,102907,14016,1234,4446,12844,32540
f,f,2012,0,0,0,0,0,0,0
u,m,1825,1389,46954,3846,321,1333,921,6421
u,f,1704,0,0,0,0,0,0,0
u,m,1795,43,188,37,6,17,5,65
f,m,1703,30,582,115,12,117,263,507
f,u,1879,513,115913,20130,1957,5346,15595,43028
f,m,1996,6188,499982,225903,14546,37753,122132,400334
f,u,1867,294,57774,10382,786,2413,7245,20826
f,m,1734,0,0,0,0,0,0,0
m,f,1794,88,8226,1856,172,619,1668,4315
u,u,1754,0,0,0,0,0,0,0
f,m,1730,0,0,0,0,0,0,0
m,u,1849,384,40861,7814,713,2053,5714,16294
m,m,1741,68,6160,1367,107,342,646,2462
u,u,1997,21982,419628,112988,8087,22697,24382,168154
u,f,1939,2029,47233,12750,901,2595,2433,18679
u,f,1954,3117,64953,17575,1289,3740,3792,26396
m,f,1851,1471,172641,28880,2877,8590,21479,61826
f,f,1745,0,0,0,0,0,0,0
u,u,1804,30,173,96,6,38,17,157
f,m,1916,4024,768845,167228,12898,36117,94021,310264
m,m,1948,17257,1782021,608143,40882,103290,269175,1021490
f,m,1999,6054,479994,247732,16245,41904,131421,437302
m,u,1854,855,112405,15636,1357,3873,9274,30140
f,m,1989,8590,804530,332883,22536,58761,172447,586627
u,m,1790,18,0,27,5,12,3,47
m,u,1792,0,0,0,0,0,0,0
f,f,1732,0,0,0,0,0,0,0
u,f,1767,0,0,0,0,0,0,0
m,u,2006,29729,1482410,738784,49845,131706,359042,1279377
u,m,2003,10778,146451,54111,3713,11227,12005,81056
f,f,1974,2671,346837,133140,9434,23837,71987,238398
m,m,1973,21826,1653278,665902,42939,110510,303505,1122856
u,m,1940,6517,147642,35771,2419,7302,7279,52771
f,m,1973,6654,473918,195024,14170,36139,99604,344937
u,u,1801,8,6,4,4,4,1,13
f,u,1952,6809,748708,256607,20423,51511,147323,475864
u,u,1820,52,1103,109,13,32,28,182
f,f,2003,6348,665602,356123,23769,58565,197010,635467
f,u,1991,14487,969499,458235,33881,87402,256623,836141
u,f,1802,51,8060,401,37,187,102,727
f,m,1940,3978,443998,161529,11595,30400,80030,283554
f,m,1935,5586,572743,208075,15937,40016,115828,379856
f,f,1993,5455,504717,266270,17686,43972,143831,471759
f,u,1889,402,60680,11946,1070,2895,9755,25666
u,m,1851,1093,44860,3836,309,1459,520,6124
f,m,1898,4826,834620,147406,11916,36641,96715,292678
f,u,1758,0,0,0,0,0,0,0
f,m,1848,806,135904,18926,1487,5702,16551,42666
u,f,1805,74,1479,260,15,99,37,411
u,u,1811,109,8015,581,41,199,89,910
u,f,2006,5730,108928,41539,2725,7452,9019,60735
u,m,1726,83,15,76,6,27,12,121
u,f,1827,500,10154,1197,100,483,307,2087
f,u,1806,1,0,6,1,1,1,9
m,m,1751,155,2998,1270,120,468,933,2791
u,f,1923,1361,25354,6308,557,1591,1339,9795
u,f,1909,2539,74630,10352,876,2469,2317,16014
m,f,1887,5305,666325,134446,12313,32908,79175,258842
f,u,1850,16,1484,278,26,70,251,625
u,f,1780,0,0,0,0,0,0,0
m,f,1897,6220,896179,170167,14605,39015,99411,323198
f,m,1991,6757,494591,250243,16897,43289,134118,444547
m,u,1864,971,117048,17175,1553,4220,10231,33179
m,m,1946,18848,1708839,584816,39812,101176,259235,985039
f,f,1977,3058,375578,146108,10644,25853,75233,257838
u,u,1956,13853,327346,78161,5293,16703,15933,116090
u,m,1931,6290,146130,31331,2301,7519,6758,47909
m,f,2012,0,0,0,0,0,0,0
m,m,1765,0,0,0,0,0,0,0
f,u,1982,11389,882756,365110,27941,69111,193225,655387
m,u,1918,4307,374619,90009,6173,20923,41849,158954
u,m,1956,9897,168777,46705,3261,9611,8601,68178
f,u,1778,0,0,0,0,0,0,0
m,u,1995,32357,1579556,682962,49012,132994,341471,1206439
f,f,1749,0,0,0,0,0,0,0
u,m,1750,67,0,101,15,46,26,188
m,f,1895,5306,684369,125537,10721,30530,68103,234891
f,f,1804,129,7032,3311,341,957,2417,7026
u,u,1748,13,0,15,1,6,2,24
f,f,1870,1414,363047,65478,5804,15930,47835,135047
m,m,1784,656,17264,5461,530,1947,4605,12543
m,u,1958,18225,1335167,529375,36404,98686,258216,922681
m,m,1795,109,21384,2652,206,980,2585,6423
f,m,1794,6,24,19,3,10,41,73
m,f,1876,3015,465338,84220,7551,21071,50387,163229
m,m,1734,0,0,0,0,0,0,0
u,u,1862,175,4217,328,39,107,99,573
u,f,1863,722,16075,1948,182,606,434,3170
u,m,1862,1522,42228,5053,447,1398,790,7688
m,u,1751,21,27,99,13,37,63,212
f,m,1866,1498,270733,40623,3744,11590,31508,87465
f,f,1731,0,0,0,0,0,0,0
m,m,1740,100,13175,1876,98,735,1250,3959
u,f,1921,2131,75062,10554,827,2660,2425,16466
f,u,1817,75,9578,2241,186,1049,1892,5368
f,u,1980,10526,748685,323460,24234,60469,177113,585276
m,f,1916,5353,766369,165000,12979,35186,83274,296439
u,m,1725,0,0,0,0,0,0,0
u,m,1947,10871,196547,50409,3685,10881,10302,75277
u,m,1791,77,2007,371,32,97,73,573
f,m,1922,6273,1019984,240171,19023,50020,139480,448694
u,f,1830,314,14831,929,102,364,252,1647
f,u,1877,213,30050,5320,478,1347,3895,11040
m,u,1759,0,0,0,0,0,0,0
m,m,1717,0,0,0,0,0,0,0
m,f,1842,1139,132755,21412,1955,6337,15976,45680
m,f,1983,6842,509243,235946,17006,42181,107692,402825
f,u,1809,17,519,245,30,87,215,577
u,f,1738,0,0,0,0,0,0,0
m,f,1814,863,80549,19426,1582,5777,16775,43560
m,m,1787,77,4371,842,82,239,783,1946
m,u,2001,26592,1392833,603275,42154,111600,302125,1059154
m,f,1890,5348,649721,126871,11634,31585,75570,245660
f,u,1922,3215,326387,102543,7638,23582,57879,191642
m,m,1971,21840,1617749,629297,40903,107029,283102,1060331
m,f,1885,3453,522198,97702,8903,24040,53784,184429
u,f,1747,0,0,0,0,0,0,0
u,f,1869,1108,39084,4124,387,1268,1002,6781
m,m,1761,32,1041,1366,112,445,1035,2958
m,u,1955,22216,1783083,631334,44124,116191,308354,1100003
m,u,1871,575,66096,11473,1085,2854,6951,22363
m,f,1914,5582,781079,167068,12347,36090,87745,303250
m,m,1993,19426,1231600,586012,37977,100457,264550,988996
m,m,1900,10330,1129580,221954,16845,51971,124935,415705
f,m,1933,4686,490729,172119,14110,34223,95053,315505
m,u,1786,0,0,0,0,0,0,0
m,f,1910,6148,808005,158766,12978,34566,84282,290592
u,m,1945,6833,129396,33452,2315,6928,5681,48376
u,m,1966,12570,226380,68749,4186,12868,13837,99640
f,u,1716,0,0,0,0,0,0,0
m,m,1851,2326,359641,52152,3809,16376,32794,105131
f,u,1860,455,78043,12835,1099,3642,10718,28294
m,u,1884,515,56225,10870,1148,2954,5791,20763
u,m,2008,9138,115276,48605,2935,8731,11411,71682
m,m,1748,15,0,42,3,10,31,86
m,f,1991,10024,537118,283542,20496,51072,127572,482682
u,u,1736,0,0,0,0,0,0,0
m,u,1788,22,980,363,45,120,259,787
f,f,1840,750,192767,27277,2305,8669,23641,61892
u,m,1707,0,0,0,0,0,0,0
m,f,1959,4767,431319,151723,10920,27570,67775,257988
u,m,1987,13077,243073,73884,4567,13673,15553,107677
u,m,1867,1374,37858,4382,413,1316,926,7037
m,f,1718,0,0,0,0,0,0,0
f,m,2012,0,0,0,0,0,0,0
u,u,1751,29,0,27,1,17,5,50
u,m,1914,6096,163227,23316,1920,6527,5292,37055
m,f,1907,4839,548773,113776,8775,24735,62511,209797
f,f,1734,0,0,0,0,0,0,0
m,f,1929,5349,498350,169792,13506,34641,89762,307701
m,u,1964,24706,1747848,660010,46713,127310,327387,1161420
u,m,1959,10597,251594,61082,3599,11495,11226,87402
u,m,1938,6557,130553,32058,2367,6836,6597,47858
u,f,1904,2340,92703,11535,773,2554,2447,17309
f,f,1898,3389,710026,122839,10572,27907,86983,248301
m,f,1831,669,81215,10965,958,3300,8344,23567
f,m,1883,4353,629401,119449,11337,31062,84892,246740
f,f,1959,2445,339399,126766,8384,20907,64114,220171
m,m,1818,630,57287,6465,575,2099,4771,13910
u,u,1795,15,1095,86,5,16,29,136
m,m,1923,13553,1430163,439062,32180,88361,234964,794567
f,f,2001,6295,672050,331715,21520,53546,176367,583148
m,m,1944,11566,1014534,350793,24764,61495,155189,592241
f,f,1717,0,0,0,0,0,0,0
f,f,1989,7019,883004,384211,25589,63562,202765,676127
u,u,1922,5261,86920,23237,1870,6034,5299,36440
m,f,1867,3125,509426,80950,7394,21570,48556,158470
f,m,1983,5969,529267,223328,14895,38935,114696,391854
m,u,1731,0,0,0,0,0,0,0
f,m,1824,478,53262,8017,702,2654,7853,19226
u,m,1952,9232,201925,50423,3524,10322,10746,75015
f,m,1781,23,276,80,11,58,80,229
f,u,1984,10794,764471,363513,26463,66136,201741,657853
m,f,1861,1227,105020,20409,2001,5471,13219,41100
u,m,1991,11315,198753,62941,4340,13486,13846,94613
u,m,2001,10522,164479,54115,3351,10060,11865,79391
f,m,2004,7802,510349,280593,18766,48276,148087,495722
u,m,1937,8008,131756,31605,2408,7203,6690,47906
u,u,1930,13025,326186,72734,5126,16355,15228,109443
m,f,1935,6320,529391,186130,14668,37112,92204,330114
m,f,1714,0,0,0,0,0,0,0
u,m,1762,306,9691,184,5,135,31,355
u,u,1888,413,10913,1457,158,424,422,2461
u,m,1787,27,13,30,1,10,11,52
f,u,1883,328,43524,6877,684,1873,5329,14763
m,m,1797,166,11135,1467,124,555,1017,3163
u,m,1908,4974,137209,22294,1718,5476,4452,33940
m,f,1968,5453,458635,187284,13521,34559,83513,318877
m,f,1744,0,0,0,0,0,0,0
f,u,1888,422,63170,10222,871,2385,7810,21288
f,u,1767,0,0,0,0,0,0,0
f,f,1915,4113,1020951,198310,14372,39626,122253,374561
f,u,1875,134,23137,4914,497,1182,3587,10180
f,f,1900,2957,560863,105142,8578,23731,70677,208128
m,u,1911,4230,466484,81963,5797,21854,38314,147928
m,f,1933,4960,476031,163598,12830,32691,79668,288787
m,f,1936,7390,667764,226258,18081,46085,108754,399178
u,u,1918,2151,34446,7398,563,2004,1320,11285
f,m,1771,0,0,0,0,0,0,0
f,u,1884,222,28630,7057,734,1775,4292,13858
f,f,1960,2661,309236,131061,9370,22392,65480,228303
m,u,1752,22,0,213,24,69,124,430
m,f,1985,10253,924517,333971,23011,60164,156674,573820
f,u,1931,5722,477167,192693,16210,41203,116688,366794
f,m,1926,4226,569003,175748,13988,35074,100846,325656
u,u,1909,1479,48124,6692,495,1719,1162,10068
u,f,1835,977,18619,1928,194,626,539,3287
u,m,1982,12290,315956,80693,4913,14620,16220,116446
u,u,1838,105,2701,175,17,44,42,278
m,u,1821,234,25095,5743,422,1767,5360,13292
m,m,1815,507,58802,7698,631,2308,6088,16725
f,u,1750,0,0,0,0,0,0,0
m,u,1929,19687,1419963,475185,36643,104895,262205,878928
u,u,1707,0,0,0,0,0,0,0
f,u,1957,8017,835590,319620,24589,61107,167414,572730
f,m,1718,0,0,0,0,0,0,0
u,m,1819,442,15021,862,73,281,309,1525
u,m,1773,8,0,10,1,2,0,13
u,u,1773,0,0,0,0,0,0,0
f,u,1909,933,133876,28521,2207,6320,18289,55337
u,u,1724,0,0,0,0,0,0,0
u,u,1731,0,0,0,0,0,0,0
f,f,1814,535,114367,22651,1791,7373,21425,53240
m,m,1857,4740,800850,98283,7849,27795,67089,201016
u,m,1782,27,63,48,8,19,7,82
m,u,1822,498,48657,5170,318,2030,4598,12116
u,f,1729,0,0,0,0,0,0,0
m,f,1730,0,0,0,0,0,0,0
u,m,1910,6798,141151,21072,1597,5850,5029,33548
u,f,1947,2675,44626,12605,979,2761,2737,19082
m,m,1914,13267,1972679,388627,28684,83561,195994,696866
f,u,1834,130,22784,2610,194,751,2486,6041
u,f,1999,5695,76858,29989,2118,6212,7611,45930
f,f,1933,2528,345976,135142,10095,23826,75501,244564
u,f,1888,1782,55972,7422,756,2202,1995,12375
m,f,1953,5766,560758,206885,14956,37955,90222,350018
m,u,1877,419,46866,8454,737,1927,5358,16476
f,u,1997,12823,808311,384060,27780,72198,216865,700903
f,m,1819,203,38757,3815,342,1110,3684,8951
m,f,1883,4793,536295,113198,11066,27852,64502,216618
m,m,1840,3646,499887,69976,5408,20886,49672,145942
f,u,1753,0,0,0,0,0,0,0
m,f,1989,12953,1257026,448940,30253,79745,204499,763437
m,u,1837,167,20730,2506,182,793,1900,5381
f,m,1804,192,15955,3356,289,1093,2979,7717
u,m,1818,290,7175,488,43,197,137,865
u,u,1836,68,4239,431,38,178,73,720
u,m,2007,10382,155911,50909,3268,9994,10928,75099
f,u,1791,8,0,12,0,3,13,28
f,m,1881,1895,408257,73839,7004,18123,49919,148885
m,f,2004,11320,822186,375053,26223,67125,167960,636361
f,u,1958,5839,522471,205453,14944,39229,112971,372597
m,u,1946,23870,1766578,618137,45559,114795,299500,1077991
m,f,1973,6231,455877,184267,14100,34750,86724,319841
m,u,1713,0,0,0,0,0,0,0
u,u,1849,151,2664,260,16,78,53,407
m,m,2003,21415,1494073,652026,41641,109562,294424,1097653
f,m,1862,640,86098,14669,1301,4150,12227,32347
u,f,1855,820,31031,2156,188,684,386,3414
f,f,1797,82,18173,3218,255,1132,2974,7579
m,f,1849,1074,147230,24486,2038,6950,18911,52385
f,m,1744,0,0,0,0,0,0,0
f,u,1990,15803,1065373,492043,35954,88913,271946,888856
m,f,1898,6119,729047,138106,12090,32140,80660,262996
f,f,1949,3246,567920,189326,13377,31572,94702,328977
u,u,1882,1138,22084,2409,207,661,652,3929
u,m,1789,44,1142,332,23,102,97,554
u,u,1835,121,3315,263,29,102,100,494
f,u,1988,13026,916522,403823,30387,75397,226639,736246
u,m,1893,7820,314954,37179,2536,11195,5602,56512
f,m,1992,5862,443596,211505,13988,36054,106823,368370
f,u,1707,0,0,0,0,0,0,0
u,m,1706,0,0,0,0,0,0,0
u,f,1809,279,7101,950,79,328,247,1604
u,f,1932,2039,35387,10066,848,2427,2616,15957
m,f,1923,2763,270831,83596,6480,17155,40996,148227
f,m,1887,2595,438102,82911,7681,19860,56322,166774
m,f,1926,3963,314549,107971,8481,22109,54498,193059
u,m,1716,0,0,0,0,0,0,0
f,u,1968,12150,965207,397690,29246,79147,224547,730630
f,m,1897,3671,683780,123880,9838,30032,80666,244416
m,f,2006,11560,812415,420458,29383,75152,195684,720677
m,u,1965,28887,1820545,741936,53678,142235,358599,1296448
f,f,1858,966,290064,46213,3952,12236,35726,98127
u,u,1798,0,0,0,0,0,0,0
u,u,1746,0,0,0,0,0,0,0
m,u,1990,39633,2084983,886373,64394,167003,446812,1564582
f,u,1955,6818,781683,263188,18951,49486,144019,475644
u,u,1919,1807,33896,6265,564,1599,1410,9838
m,m,1999,19712,1395596,612379,37436,104872,280867,1035554
u,u,1898,425,7325,993,121,339,295,1748
m,f,1799,215,32720,5418,545,1969,4752,12684
u,f,1751,12,66,60,6,19,9,94
u,u,1954,11783,312432,81351,4959,16063,15461,117834
m,f,1860,2399,281092,49358,4508,13186,32960,100012
f,u,1771,0,0,0,0,0,0,0
m,m,1870,3804,625164,95628,7689,26529,60311,190157
f,f,1784,25,3616,678,73,297,440,1488
f,f,1795,90,24624,6293,353,1877,5168,13691
u,u,1860,495,36018,2661,240,866,526,4293
f,f,1724,0,0,0,0,0,0,0
f,m,1753,8,89,86,9,64,70,229
m,m,1883,11728,1350313,236296,21134,60809,148125,466364
m,f,1866,2553,420225,66912,6315,17197,42525,132949
u,m,1724,0,0,0,0,0,0,0
m,m,1933,14476,1550139,466125,32895,87449,223053,809522
f,f,1740,0,0,0,0,0,0,0
m,m,1910,15079,2001928,389194,27932,86907,202868,706901
u,u,1781,4,15,3,1,4,1,9
u,u,1868,431,6600,1339,122,447,190,2098
u,u,1828,139,4489,257,22,81,63,423
u,f,1795,104,4613,996,70,354,187,1607
m,f,1922,7679,977536,231251,18421,49239,116679,415590
f,m,1708,25,1018,175,23,88,298,584
m,u,1972,27403,1753421,656397,47616,126069,318260,1148342
m,u,1999,30095,1494331,703462,48627,130834,347415,1230338
f,f,1902,2092,409505,76852,6397,16567,50004,149820
f,m,1814,8,0,37,3,7,47,94
f,u,1868,538,121460,22944,1765,5709,15833,46251
m,f,1756,0,0,0,0,0,0,0
f,u,1880,369,43970,8689,832,2059,6778,18358
m,u,1895,1053,102369,23980,2046,5658,13922,45606
f,f,1935,3278,440478,166779,12701,31296,92917,303693
u,f,1882,2164,78084,9902,809,2794,2388,15893
f,u,1865,424,65950,12013,1042,2850,8367,24272
f,f,1761,0,0,0,0,0,0,0
f,m,1849,764,89155,14930,1487,4641,12337,33395
u,u,1969,23963,400669,109682,8209,24011,22677,164579
m,f,1761,0,0,0,0,0,0,0
f,m,1914,4574,959091,193648,14679,41583,111562,361472
u,m,1983,12246,373372,85454,4889,15396,17490,123229
u,u,1703,0,0,0,0,0,0,0
m,m,1949,17266,1744728,556324,37449,98561,247742,940076
f,m,1910,4384,709077,142453,10860,31117,86087,270517
u,m,1705,0,0,0,0,0,0,0
m,m,1972,18647,1392373,552086,35778,94496,244832,927192
u,u,1850,54,5146,371,14,117,45,547
u,f,2003,5859,108415,38529,2598,7089,8688,56904
f,m,1879,898,174898,34359,2951,8689,23245,69244
m,u,1753,0,0,0,0,0,0,0
f,f,1831,381,93755,12986,1131,4057,12014,30188
m,u,1758,0,0,0,0,0,0,0
f,f,1766,11,0,101,15,40,116,272
m,m,1738,0,0,0,0,0,0,0
u,f,1711,0,0,0,0,0,0,0
m,u,1814,40,7755,994,92,298,679,2063
f,m,1865,1125,203916,31095,2580,8498,22481,64654
u,m,1884,4073,90638,11681,1101,3845,2733,19360
m,u,1740,0,0,0,0,0,0,0
f,f,1999,6580,760009,367372,24132,59795,197980,649279
u,f,1785,127,1700,825,54,263,111,1253
m,f,1899,6862,963101,165092,13934,37352,91611,307989
u,u,1933,7506,124725,31503,2459,7673,6513,48148
m,f,1833,1262,163714,27362,2493,8418,20173,58446
m,u,1950,21911,2098398,703362,49887,143538,357795,1254582
m,m,1838,1608,198185,26978,2154,8227,20537,57896
u,f,1726,0,0,0,0,0,0,0
u,m,1909,5421,134550,19739,1555,5163,4623,31080
f,f,1790,0,0,0,0,0,0,0
u,f,1745,0,0,0,0,0,0,0
u,m,1870,2055,64304,7496,660,2304,1359,11819
u,m,1757,0,0,0,0,0,0,0
m,m,1898,15406,2115983,367677,27599,91098,213147,699521
f,m,1831,817,162248,17339,1370,5238,16476,40423
f,u,1961,9217,816153,323295,24360,60303,180333,588291
m,f,1705,0,0,0,0,0,0,0
u,m,1891,5070,157257,19365,1828,5205,4015,30413
f,m,1705,0,0,0,0,0,0,0
f,f,1923,1446,182128,68241,5556,13484,38829,126110
f,f,1869,1576,361707,67474,6367,15757,49079,138677
f,f,1951,3308,567390,184653,12655,30557,90738,318603
f,u,1826,56,7596,1402,81,540,1330,3353
f,u,1947,7536,864133,298006,22596,53625,160075,534302
u,f,1927,2354,46401,11542,1076,2929,3092,18639
f,u,1946,7523,636785,249955,19675,46939,135834,452403
u,m,1873,1560,57852,5499,489,1695,1196,8879
m,u,1968,41082,2259417,903660,66147,186729,446461,1602997
f,u,1849,163,14220,2885,271,843,2454,6453
f,m,1889,2778,434171,85246,7442,21085,58026,171799
u,u,1910,2640,54182,9437,720,2427,1962,14546
m,u,1906,2410,302509,58414,4482,14057,30542,107495
u,f,1862,520,18686,2414,203,691,627,3935
u,u,1766,0,0,0,0,0,0,0
u,f,1842,551,16665,2139,180,771,387,3477
m,m,1721,0,0,0,0,0,0,0
f,f,1705,0,0,0,0,0,0,0
f,f,1890,2759,533197,104821,9640,25098,73615,213174
u,f,1750,0,0,0,0,0,0,0
m,u,1724,0,0,0,0,0,0,0
u,f,1962,3024,47130,15454,1036,3506,2947,22943
u,u,1871,181,2973,410,33,145,93,681
u,m,1958,9115,181396,51108,3905,10563,9698,75274
m,f,1797,94,19491,3224,244,992,2621,7081
f,u,1811,72,12413,2273,166,721,2542,5702
u,m,1890,5566,186941,19881,1731,5870,4477,31959
u,f,1783,0,0,0,0,0,0,0
u,m,1780,24,0,10,2,12,7,31
f,m,1936,4115,503147,171407,12875,32170,93016,309468
m,m,1807,160,9938,2537,186,853,2195,5771
f,m,1949,5291,572439,193582,14566,36130,99329,343607
u,m,1744,0,0,0,0,0,0,0
u,u,1711,0,0,0,0,0,0,0
f,f,1972,2155,248100,93336,6579,16530,49456,165901
m,m,1960,17869,1557540,571158,38692,98834,245811,954495
u,f,1816,262,5463,777,63,286,162,1288
f,u,1956,7533,755236,278832,21312,54741,151171,506056
u,m,1978,12284,235981,67633,4211,12530,12935,97309
m,u,1791,22,100,183,13,55,128,379
u,f,1985,5225,191432,44108,2726,7972,10946,65752
f,f,1738,0,0,0,0,0,0,0
f,u,1965,9391,714586,293283,23266,58628,160563,535740
m,f,1865,2944,408515,70513,6496,18098,43003,138110
u,m,1846,1369,25094,2951,280,1073,577,4881
m,m,1904,10589,1260220,246502,18940,56523,131682,453647
u,m,1994,10118,172668,51622,3447,10215,11625,76909
m,f,1821,398,61076,13952,1002,4144,12422,31520
u,m,1738,0,0,0,0,0,0,0
u,m,1926,6757,214359,32718,2509,7404,6857,49488
m,u,1774,12,16,37,4,10,45,96
m,u,1862,533,78166,13178,1381,3483,8174,26216
f,m,1899,5629,878214,158837,12932,38190,106935,316894
f,u,1932,4281,407179,159400,12440,31783,93220,296843
u,f,1803,86,2543,418,40,158,110,726
m,m,1820,689,68529,9665,762,2873,7096,20396
f,f,1838,635,139883,17754,1568,5643,17982,42947
u,m,1771,0,0,0,0,0,0,0
f,f,1857,1376,340602,61142,5499,16420,48377,131438
u,m,1955,10591,207825,59293,4029,11435,10883,85640
m,f,1798,204,12450,2470,231,785,2042,5528
u,u,2012,0,0,0,0,0,0,0
f,f,1914,3267,805943,148264,10928,30111,92280,281583
f,u,1828,172,29670,4359,343,1143,2738,8583
f,f,1779,18,2623,201,29,87,240,557
m,f,1945,6248,748460,220651,15644,38739,94998,370032
m,m,1788,258,21328,4199,347,1515,2737,8798
u,f,1879,995,32426,4017,416,1146,1008,6587
u,f,1886,2330,75842,9225,878,2611,2276,14990
m,f,1819,255,23273,4179,377,1386,3169,9111
m,f,1752,0,0,0,0,0,0,0
u,m,1974,11654,204510,58426,3732,11876,11541,85575
u,f,1867,1459,37555,3806,376,1208,901,6291
m,u,1709,0,0,0,0,0,0,0
u,f,1851,582,13113,1361,132,536,481,2510
m,u,1917,3458,362139,81403,6328,18909,40969,147609
u,u,1879,703,21023,1811,181,556,327,2875
u,f,2000,5552,87835,33051,2268,6367,7919,49605
m,f,1782,0,0,0,0,0,0,0
f,u,1936,5541,548031,185893,14383,34433,103800,338509
u,u,1821,74,398,81,8,46,24,159
u,u,1788,4,39,5,0,0,0,5
f,m,1854,1183,155498,22168,1976,6589,19167,49900
u,m,1865,1608,39120,4320,365,1385,1018,7088
f,m,1882,2178,332691,71553,6503,17880,50396,146332
f,m,1759,12,486,82,3,64,68,217
u,f,1959,2642,96059,21203,1379,4001,4273,30856
f,f,1925,2041,274228,108630,8383,21392,63695,202100
f,f,1912,3698,808840,150498,11598,31272,95249,288617
f,m,1845,751,121622,17880,1460,5371,15215,39926
f,u,1781,8,68,20,3,19,60,102
f,m,1754,5,0,4,0,3,6,13
u,m,1868,1638,43538,5348,486,1733,1115,8682
f,m,1967,6863,569943,249454,17660,45714,127373,440201
f,m,1775,0,0,0,0,0,0,0
f,u,1926,5535,532406,184114,15250,40714,111901,351979
f,m,1797,45,2052,250,42,146,304,742
f,m,1890,3243,607428,107679,9494,26836,74406,218415
m,u,1757,0,0,0,0,0,0,0
u,m,1921,7236,224911,35105,2581,8747,8209,54642
u,m,1877,2333,87531,8115,651,2477,1950,13193
f,f,1807,215,27888,8318,526,3138,9308,21290
m,f,1949,6289,649716,207962,15105,37415,94130,354612
m,f,1998,10815,729392,330456,23619,61693,159601,575369
u,f,1952,3283,69048,19058,1419,4272,4499,29248
m,u,1915,3176,390756,86221,6207,21302,41993,155723
u,u,1792,0,0,0,0,0,0,0
m,f,1992,10380,663113,318860,22399,56959,145227,543445
m,u,1989,35509,1770353,816718,58443,153980,397389,1426530
m,u,1979,31201,1908928,734964,52838,140724,348747,1277273
m,m,1962,19374,1710155,621055,40876,105545,258839,1026315
u,m,1720,0,0,0,0,0,0,0
u,u,1720,0,0,0,0,0,0,0
f,m,1923,4608,575681,188181,15097,38962,111403,353643
f,f,1713,0,0,0,0,0,0,0
u,m,1935,9414,207672,53677,3811,11302,11194,79984
u,u,1704,0,0,0,0,0,0,0
u,u,1784,13,25,12,4,5,5,26
f,u,1722,4,0,23,1,6,13,43
u,m,1734,0,0,0,0,0,0,0
m,m,1890,10062,1458108,228801,18850,56515,139653,443819
m,m,1858,2724,399946,55316,4556,16170,36661,112703
m,m,2006,21417,1211161,611774,39106,104473,285940,1041293
f,u,1728,0,0,0,0,0,0,0
f,u,1779,5,0,19,1,7,23,50
f,m,1858,860,151113,22525,1993,7204,17495,49217
u,m,1703,273,7374,429,41,219,44,733
m,u,1976,33946,2043804,786523,57963,154822,384668,1383976
f,f,1716,0,0,0,0,0,0,0
u,f,1960,2984,46694,14677,1147,3288,3171,22283
u,f,1938,3154,58159,15817,1139,3594,3387,23937
u,u,1975,19816,386876,99285,7179,21268,19626,147358
f,m,1860,1039,165364,26791,2399,7885,23196,60271
m,u,1769,39,1564,615,83,234,426,1358
m,f,1862,1334,189616,32400,2922,9041,18558,62921
u,u,1945,9100,212232,47432,3256,10031,8982,69701
m,u,1840,309,26614,4279,349,1384,3825,9837
f,m,1728,11,382,119,7,37,95,258
f,f,1798,181,16353,2764,302,1007,3211,7284
u,u,1839,184,5544,474,40,214,100,828
u,m,1960,9271,176730,48406,3055,9554,9187,70202
m,m,1975,19114,1681665,645648,40349,109762,290931,1086690
f,f,1788,0,0,0,0,0,0,0
u,m,1876,2227,81675,8853,801,2595,1535,13784
f,f,1910,3310,724493,142476,11143,28826,91264,273709
f,f,1964,2523,262897,113814,8730,19550,54560,196654
u,u,1760,11,0,28,3,8,9,48
f,m,1752,38,433,1538,156,867,1576,4137
m,f,1784,42,11138,1366,129,523,675,2693
f,m,1878,1984,240398,47630,4382,12418,35313,99743
u,m,1763,89,476,127,16,47,39,229
m,u,1894,698,77432,17478,1621,3808,10476,33383
u,f,1916,2477,63774,10251,863,2676,2474,16264
m,u,1721,0,0,0,0,0,0,0
u,u,1965,20442,348042,103898,7110,22377,20970,154355
u,m,1900,5708,157043,21127,1643,6237,4479,33486
m,f,1882,4058,530137,102289,8603,24798,55792,191482
m,u,1908,5100,315742,65580,4478,14849,35752,120659
m,m,1821,760,83974,13234,997,3696,10449,28376
m,m,1832,1417,266310,34163,2905,10418,26025,73511
m,m,1830,2228,306474,38503,3046,11963,32789,86301
m,m,1925,13137,1458147,422790,32071,83558,224500,762919
m,u,1808,126,13476,1724,175,573,1251,3723
f,f,1852,1009,278852,45852,3570,11390,39539,100351
f,m,1885,2325,406718,73422,6378,18197,50471,148468
u,f,1718,0,0,0,0,0,0,0
m,f,1845,2673,335305,47144,4373,15831,43845,111193
f,u,1836,111,7886,1541,186,481,1523,3731
m,f,1754,0,0,0,0,0,0,0
u,m,1941,6113,122449,29438,2132,6478,6707,44755
m,f,1967,4832,360640,150065,11294,27984,67550,256893
m,f,1775,16,383,186,19,80,189,474
f,m,1761,28,1887,1337,121,793,1336,3587
m,u,1784,28,2209,237,19,96,160,512
m,f,1788,0,0,0,0,0,0,0
m,f,1877,2677,334832,64263,6064,16011,39702,126040
f,f,1945,3286,511610,172054,12198,29526,90749,304527
f,u,1842,80,9033,1277,101,386,1260,3024
f,f,1844,690,172610,23179,2128,6823,19438,51568
m,u,1900,27919,3236315,688397,53350,166241,394030,1302018
f,u,1712,0,0,0,0,0,0,0
u,u,1737,0,0,0,0,0,0,0
m,f,2002,11560,793263,360722,25565,63817,164036,614140
f,u,1810,69,4563,1026,83,348,1123,2580
m,f,1954,6770,588037,222188,15945,41996,104621,384750
u,u,1875,203,2653,576,55,191,132,954
f,m,1976,6052,552082,224577,15010,39632,114386,393605
m,m,1713,0,0,0,0,0,0,0
f,u,1744,2,0,10,1,7,15,33
u,u,1883,422,12963,1290,119,409,340,2158
u,m,1871,2028,56688,6727,613,2223,1164,10727
u,u,1938,8337,127474,40412,2908,8838,7896,60054
m,f,1852,1655,273871,40058,3370,10195,27507,81130
u,f,1874,958,29595,3741,327,1073,981,6122
u,f,1794,40,308,47,7,12,8,74
u,u,1946,14732,329713,67719,4921,15049,13406,101095
f,f,1876,2021,463530,81434,7431,19348,58371,166584
f,u,1714,0,0,0,0,0,0,0
m,u,1902,3178,269326,53180,4251,13218,30182,100831
u,u,1854,432,16969,1336,108,481,308,2233
f,u,1846,190,39354,4422,439,1604,4237,10702
u,u,1794,15,10,26,3,8,2,39
m,f,1820,654,71915,17838,1513,5397,12577,37325
f,u,1823,91,21768,3566,301,996,2987,7850
f,m,1873,1075,210643,34011,3059,9367,25346,71783
f,u,1897,287,34820,7656,706,1755,5396,15513
u,m,1769,32,0,20,3,10,2,35
f,m,2011,32,4590,1139,25,172,509,1845
u,m,1932,6910,144747,33841,2316,7619,7281,51057
u,f,1949,2688,55725,14710,1095,3035,2933,21773
u,u,1767,0,0,0,0,0,0,0
u,m,1930,8719,171083,39513,2838,9239,8277,59867
m,u,1725,12,0,191,11,66,145,413
u,f,1818,292,9779,1223,119,429,433,2204
f,u,1887,263,45761,7236,651,1767,5492,15146
m,u,1794,65,8650,1717,172,494,1412,3795
m,m,1964,20451,1871865,684496,44876,114811,299636,1143819
f,f,1833,722,159141,24457,2112,7429,21706,55704
f,u,1918,1431,213477,44651,3138,10637,23562,81988
u,u,1787,2,0,2,1,1,0,4
f,m,1962,6209,598665,205943,14756,37646,100872,359217
m,f,1832,1307,168457,28501,2485,7924,21267,60177
m,m,1951,18188,1965822,666161,44547,114957,290032,1115697
u,u,1902,1904,53101,7112,578,1889,1509,11088
m,f,1878,3031,444157,75177,7038,17601,44538,144354
f,f,1770,16,3192,179,20,88,208,495
m,u,1851,489,47252,5851,535,1642,4547,12575
f,u,1785,9,316,157,11,46,73,287
m,m,1891,9245,1069290,202661,17820,48612,116316,385409
u,u,1771,0,0,0,0,0,0,0
f,u,1974,8405,555431,267335,21186,54462,155743,498726
m,f,1889,5245,771535,140486,13138,34269,81292,269185
f,u,1901,1197,217364,37099,3157,8549,24976,73781
u,u,1915,1974,56773,9899,768,2509,1821,14997
f,m,1735,2,0,0,0,0,0,0
u,m,1894,7227,198560,23550,1855,6854,4464,36723
u,u,1757,0,0,0,0,0,0,0
u,f,1854,702,15173,1874,214,635,380,3103
f,f,1789,0,0,0,0,0,0,0
f,f,1721,0,0,0,0,0,0,0
m,m,1852,4445,667757,89397,7715,25631,63040,185783
u,u,1897,393,19924,1606,129,323,364,2422
f,f,1894,3159,763336,128891,10920,29348,89868,259027
m,u,1737,0,0,0,0,0,0,0
m,u,1907,2675,255084,59210,4502,14514,31352,109578
f,u,1723,0,0,0,0,0,0,0
m,f,1786,74,18169,2426,212,944,1726,5308
u,u,1764,0,0,0,0,0,0,0
m,u,1866,319,34734,6165,659,1653,3725,12202
f,u,1905,1099,149528,27890,2242,6918,17231,54281
m,u,1952,19129,1662422,571431,42923,114920,286489,1015763
u,f,1981,3894,82906,23298,1458,4350,5571,34677
m,u,1962,28171,2160583,761637,53359,150020,377341,1342357
u,u,1912,3520,77103,14837,1222,4003,3734,23796
f,f,1990,6792,805576,347395,23557,58814,182110,611876
f,f,1755,0,0,0,0,0,0,0
f,f,1888,2313,482808,90168,8328,21837,64341,184674
m,u,1993,37867,1658467,863502,63714,163391,423904,1514511
m,u,1922,8374,591956,205514,14631,46328,101428,367901
f,m,2002,6352,503865,238507,15141,40421,128207,422276
f,m,1905,3038,487251,94547,7420,21064,59140,182171
m,u,1723,0,0,0,0,0,0,0
f,f,1878,1576,350516,69070,6337,15911,50835,142153
m,f,1823,576,80948,15378,1372,5051,12039,33840
f,f,1772,10,68,13,1,9,45,68
m,m,1782,33,1021,396,37,157,323,913
f,u,1706,0,0,0,0,0,0,0
m,m,1853,4250,358797,48011,3956,14362,34496,100825
u,f,1821,218,11174,1286,82,464,511,2343
m,u,2000,32152,1453531,677412,49054,132098,337076,1195640
m,m,1737,0,0,0,0,0,0,0
f,m,2009,4436,228618,165435,10869,28502,83808,288614
u,u,1859,243,4126,511,62,172,112,857
u,f,1934,2789,37655,10992,1002,2744,2527,17265
u,f,1724,0,0,0,0,0,0,0
u,m,1859,2629,102414,7778,648,2271,1550,12247
f,f,1820,379,61021,18881,1319,5939,14673,40812
f,u,1835,123,22331,2497,198,782,1965,5442
f,m,1970,8047,642513,261236,18887,47904,132282,460309
m,u,1825,421,50978,7100,828,2092,5764,15784
m,m,1777,57,3112,651,62,235,525,1473
u,m,1895,7201,179622,24567,2037,7227,5506,39337
m,m,1897,12091,1482870,280853,21421,65008,153925,521207
u,f,1845,1296,42577,3082,285,1255,857,5479
m,f,1847,1249,154275,21710,1807,6707,16559,46783
m,u,1745,0,0,0,0,0,0,0
m,m,2007,20398,1223483,636475,41246,105852,287985,1071558
f,f,1739,36,291,406,61,282,507,1256
f,m,1945,4255,417967,157935,11910,28597,76985,275427
m,m,1994,19377,1328453,587882,37844,99321,264204,989251
f,m,1821,221,24698,3442,302,1175,3176,8095
f,f,1872,1791,375071,60631,5781,15347,45144,126903
m,f,1747,0,0,0,0,0,0,0
u,m,1953,8972,204315,50120,3364,10157,9561,73202
m,m,1816,368,26379,4959,461,1593,4470,11483
f,f,1757,0,0,0,0,0,0,0
m,u,1909,2872,282143,60966,4488,15006,32556,113016
f,u,1919,1164,168711,37275,3008,8469,21900,70652
m,u,1739,0,0,0,0,0,0,0
m,m,1770,27,2849,354,22,153,219,748
f,u,1876,322,68523,11456,1016,3060,8863,24395
f,u,1864,449,72127,11189,1030,2594,8257,23070
f,m,1782,33,0,204,14,65,138,421
m,f,1981,8281,722067,273644,19498,50376,124440,467958
f,f,1891,2857,677099,120986,10583,27181,83385,242135
m,m,1934,15060,1684740,528559,38474,102182,258243,927458
u,f,2005,5769,103778,34109,2363,6427,7699,50598
m,u,1852,407,74610,10483,904,3022,7022,21431
u,f,1942,2361,53008,12560,1002,3026,2916,19504
f,m,1994,6152,445086,207768,13584,35842,108682,365876
u,m,1984,14029,257936,95468,5219,16953,21494,139134
m,f,1735,0,0,0,0,0,0,0
f,f,1825,287,101243,13250,955,4120,10201,28526
m,u,1806,2,324,8,0,2,3,13
m,u,1947,21446,1849274,648577,47412,118733,309939,1124661
f,f,1882,2272,507725,94622,8362,22612,65696,191292
m,f,1759,33,4849,345,20,154,230,749
u,f,1757,0,0,0,0,0,0,0
m,m,1789,87,6682,1454,132,539,949,3074
m,m,1912,15156,2154057,452902,33309,97853,226621,810685
m,u,1983,37085,1987933,783053,56076,152080,381153,1372362
u,f,1705,0,0,0,0,0,0,0
f,m,1986,6761,689076,271762,16986,45478,139586,473812
f,u,1762,0,0,0,0,0,0,0
u,u,1716,0,0,0,0,0,0,0
f,f,1934,3328,454634,168925,13298,30694,94831,307748
f,f,1845,1226,213734,31464,3130,10558,35594,80746
u,m,1963,9968,156749,50962,3406,10130,9808,74306
u,f,1727,58,259,152,27,45,22,246
f,f,1967,2545,240003,110193,8155,19259,57039,194646
u,u,1847,91,2086,281,27,102,60,470
u,u,1806,0,0,0,0,0,0,0
u,u,1812,44,2063,120,16,50,40,226
u,f,1892,2360,77954,9551,894,2834,2471,15750
u,u,1852,197,4564,584,41,164,64,853
m,m,1755,99,1689,810,71,328,709,1918
f,m,1947,6662,776519,252508,18979,45616,126038,443141
m,u,1914,3778,431766,81170,6440,20236,41917,149763
f,m,1799,59,2339,906,66,316,730,2018
u,u,2008,12064,167654,66272,4612,12982,14056,97922
f,f,1962,2540,356235,127631,9198,21288,61981,220098
u,f,2012,0,0,0,0,0,0,0
m,f,1905,3895,482178,99832,7362,21452,54643,183289
u,m,1976,11059,211500,54038,3325,10506,10697,78566
m,m,1833,2252,304036,32796,2677,9686,25857,71016
u,u,1777,0,0,0,0,0,0,0
u,f,1992,5348,122556,38171,2329,7171,9823,57494
f,f,1885,2164,475471,93188,8288,22624,66577,190677
f,f,1853,1186,310413,43768,3817,11636,34890,94111
f,f,2006,6444,730336,389139,24631,60855,214403,689028
u,f,1712,0,0,0,0,0,0,0
f,f,1976,3462,372606,150318,11719,27284,77841,267162
m,u,1913,4209,468334,91655,6728,22783,44108,165274
m,f,1858,1752,283221,47666,3882,12317,31463,95328
f,u,1808,139,17309,2072,216,822,1485,4595
u,f,1810,455,10556,1644,82,576,431,2733
u,f,1870,987,29618,3188,295,941,901,5325
u,m,1783,11,8,12,1,6,3,22
f,u,1996,14189,922248,416693,31654,78724,237187,764258
f,u,1736,0,0,0,0,0,0,0
m,m,1843,1874,295467,38015,2761,11080,27867,79723
f,f,1822,452,89950,14879,1283,4940,13811,34913
u,m,1737,0,0,0,0,0,0,0
u,u,1995,21819,368827,113461,8063,24103,26297,171924
u,m,1995,10557,200273,60910,3824,11340,12922,88996
f,u,1874,173,29973,4754,411,1344,3960,10469
m,f,1728,0,0,0,0,0,0,0
f,m,1847,589,124189,19169,1517,5905,15419,42010
m,f,1918,5679,690391,162187,12151,32988,77633,284959
m,u,1859,543,38893,9331,821,2387,5862,18401
m,m,1739,78,1149,939,74,390,435,1838
f,f,1975,3209,349361,144188,10805,25853,73911,254757
f,u,1748,6,0,104,11,61,156,332
u,m,1874,1711,62930,6197,579,1926,1380,10082
f,f,1726,0,0,0,0,0,0,0
f,u,1773,0,0,0,0,0,0,0
u,m,1901,5549,162317,21745,1607,6392,4491,34235
f,u,1930,6579,722734,246463,19110,51620,141373,458566
u,u,1890,521,15052,1881,192,512,447,3032
u,u,1817,55,960,158,25,72,52,307
m,m,1776,0,0,0,0,0,0,0
u,u,1934,8353,225721,37916,2895,9896,8191,58898
f,m,1811,223,17788,5483,456,1945,5831,13715
m,u,1765,36,1396,730,72,205,637,1644
u,u,1952,12963,343233,76787,5164,16610,15480,114041
f,f,1969,3000,355484,152669,11102,25883,73553,263207
m,f,1976,6590,532611,199464,14981,36083,83958,334486
u,u,1993,25926,396649,136256,9792,27862,31427,205337
f,f,1710,0,0,0,0,0,0,0
u,f,1918,2544,58113,9713,778,2312,2457,15260
m,m,1825,2726,373251,45717,3560,13824,37298,100399
m,m,1882,6839,752126,145692,13404,36545,89936,285577
f,f,1830,417,83010,13519,1131,3969,14066,32685
f,m,1997,7582,656184,283574,18307,49281,146821,497983
f,u,1766,0,0,0,0,0,0,0
m,f,1919,6116,883979,197177,15426,41670,98507,352780
m,f,1731,0,0,0,0,0,0,0
m,m,1845,2331,351800,45207,3592,13528,32425,94752
u,f,1974,3391,67867,20803,1467,3917,5128,31315
m,u,1780,49,2088,346,45,159,372,922
f,m,1768,31,851,125,18,57,147,347
u,m,1743,0,0,0,0,0,0,0
m,m,1967,22646,1838986,757591,49741,131261,333103,1271696
f,f,1978,3269,427742,182198,12986,30028,97105,322317
f,m,1859,1574,233059,31765,2879,9172,26912,70728
u,m,1985,12108,288762,74948,4252,12972,15492,107664
f,m,1877,1392,264510,40092,3743,10805,29416,84056
m,f,1810,648,92398,19217,1220,6468,16549,43454
u,f,2010,12,0,67,3,12,6,88
f,f,2011,0,0,0,0,0,0,0
m,u,1963,24584,1610460,650753,46854,127243,325477,1150327
m,m,1941,11925,1239280,392762,26181,69422,179739,668104
m,f,1920,6752,855270,190042,15566,41208,96612,343428
u,m,1756,6,0,7,0,5,1,13
m,m,1844,4451,817965,97356,6762,31352,67951,203421
m,u,2003,25943,1407342,593805,41644,112526,292982,1040957
m,u,1846,396,31001,3342,302,1132,2626,7402
u,f,1994,5968,147230,47547,2700,8026,11338,69611
u,f,1865,1202,41646,4197,417,1309,1118,7041
u,m,1765,0,0,0,0,0,0,0
f,m,1954,6037,636309,232270,16953,41830,116282,407335
u,f,1707,0,0,0,0,0,0,0
m,m,1764,113,1916,475,34,202,413,1124
f,u,1754,0,0,0,0,0,0,0
m,u,1763,0,0,0,0,0,0,0
m,m,1954,19404,1797876,643402,42537,107425,276151,1069515
f,u,1775,0,0,0,0,0,0,0
u,u,1943,9353,160195,41259,2754,9036,7857,60906
f,u,1772,0,0,0,0,0,0,0
u,m,1735,33,869,19,1,14,3,37
u,m,1897,6212,190616,23643,1875,6737,5132,37387
m,f,1987,10912,1027072,360751,25058,65344,169079,620232
u,f,1972,2456,53947,12686,902,2573,2573,18734
u,u,1957,13898,331968,80131,5646,17225,15947,118949
u,m,1812,1240,29983,6137,484,2152,1074,9847
m,u,1793,42,1158,418,44,158,522,1142
m,u,1766,0,0,0,0,0,0,0
f,f,1863,1161,341848,58435,5009,14771,42274,120489
f,u,1847,65,6248,1017,85,385,1024,2511
f,m,1816,65,11422,1511,116,516,1631,3774
u,f,1850,529,17451,1648,163,540,397,2748
u,f,2002,5416,78918,27674,1917,5742,6553,41886
f,f,1843,437,95540,12924,1108,4207,11931,30170
m,f,1727,13,0,272,13,94,161,540
u,m,1879,1135,32259,3411,319,1030,750,5510
m,u,1940,11151,935486,324726,22516,59665,151900,558807
u,m,1886,3378,88394,11279,963,3369,2555,18166
f,m,1820,183,15485,3313,277,1040,3078,7708
u,u,1986,20600,387835,112782,7669,22610,23322,166383
m,m,1719,11,643,39,2,16,27,84
f,f,1856,1517,392609,59601,5256,15334,48923,129114
u,f,1898,2735,88299,10285,916,2615,2447,16263
m,f,2011,0,0,0,0,0,0,0
m,u,1798,0,0,0,0,0,0,0
m,f,1881,3758,423858,93135,8191,23466,52246,177038
m,u,1848,317,38865,5311,452,1619,4203,11585
f,u,1742,0,0,0,0,0,0,0
m,u,1919,3507,356886,88178,6556,18607,41766,155107
m,f,1903,4190,478710,101502,8319,22883,56192,188896
f,u,1872,462,76318,13188,1293,3520,10046,28047
m,m,1726,73,811,157,12,45,153,367
m,u,1748,9,920,339,23,97,311,770
m,f,1964,4827,368418,154531,11314,27679,66281,259805
f,m,1888,2915,567775,99846,8242,25075,71653,204816
m,u,1938,12569,863874,338856,24844,65256,169506,598462
f,m,1832,412,95515,12496,1069,4146,10979,28690
u,m,1761,14,40,147,19,49,34,249
m,m,1869,3983,395809,67582,6409,18726,43724,136441
m,u,1875,433,31829,7589,669,2045,4155,14458
u,f,1973,3054,54171,17143,1223,3372,3967,25705
m,m,1793,58,5193,1382,161,498,834,2875
m,m,1805,95,8796,1426,111,509,1212,3258
u,u,1732,7,0,15,2,9,2,28
m,f,1811,169,8219,3471,242,1124,2989,7826
u,u,1814,27,107,17,1,9,1,28
u,m,1814,30,1026,175,16,59,36,286
m,m,1969,26348,1946826,773187,51293,131505,334826,1290811
u,u,1740,0,0,0,0,0,0,0
m,m,1710,0,0,0,0,0,0,0
f,m,1767,16,0,96,9,28,54,187
u,m,1792,43,1860,98,11,31,15,155
m,m,1780,72,3603,633,50,170,624,1477
u,u,2011,65,485,63,2,16,3,84
u,u,1807,49,591,113,15,43,25,196
m,f,1800,245,18337,4947,503,1450,3370,10270
f,u,1927,4595,378347,148665,11954,32646,88637,281902
u,f,1876,1281,51878,5858,586,1556,1736,9736
m,m,1894,13346,1779321,312231,23791,76080,173762,585864
m,f,1943,5721,620549,195326,14421,36097,87704,333548
f,u,2005,11978,751477,393091,28027,71406,219776,712300
f,f,1760,0,0,0,0,0,0,0
m,f,1768,0,0,0,0,0,0,0
f,m,1939,3599,413628,130625,9773,24527,67870,232795
u,u,1743,0,0,0,0,0,0,0
f,u,1942,3783,387734,141567,10505,26520,74935,253527
m,m,1827,1256,177427,21711,1989,6830,18137,48667
u,u,1866,111,2101,261,25,99,72,457
m,f,1839,970,115153,16948,1370,4894,13571,36783
m,u,1973,25512,1242002,577189,43361,115015,285756,1021321
m,f,1826,612,79425,12186,969,3702,10300,27157
f,m,1810,236,7992,6343,711,2261,5775,15090
u,f,1924,1853,37249,9160,732,2171,2202,14265
m,f,1946,7690,837098,250788,17558,44569,109524,422439
u,u,1789,24,0,37,11,22,10,80
m,f,1947,6685,689575,223839,16514,39663,99780,379796
f,u,1705,0,0,0,0,0,0,0
m,f,1836,1074,168288,24144,2089,7358,17473,51064
m,u,1832,1040,93053,11783,1031,3417,11463,27694
m,m,1888,8905,1231033,211441,16720,52661,126037,406859
f,u,1732,2,0,26,2,10,33,71
f,u,1940,3676,406358,144782,10469,26095,73632,254978
f,u,1939,3404,340281,115586,8315,22155,62526,208582
m,f,1708,0,0,0,0,0,0,0
f,f,1764,0,0,0,0,0,0,0
u,m,1808,308,9857,1328,115,497,484,2424
f,m,1773,14,645,227,24,131,368,750
f,u,1783,0,0,0,0,0,0,0
f,m,1823,534,74469,10238,1016,3360,10214,24828
u,u,1941,7341,125694,34151,2423,8336,8057,52967
m,u,1771,0,0,0,0,0,0,0
m,u,1873,614,77539,13872,1247,3565,8229,26913
f,f,1782,0,0,0,0,0,0,0
m,f,1952,6383,578894,218195,16235,39894,101040,375364
u,m,1736,680,10601,1412,164,686,351,2613
u,m,1796,281,2956,478,48,201,180,907
u,u,1972,17302,266205,75867,5619,16474,16343,114303
m,f,1853,1602,253331,38261,3676,10170,26082,78189
f,f,1937,3249,484283,193666,13680,31865,99076,338287
m,u,1741,16,4068,498,39,169,444,1150
m,u,1719,0,0,0,0,0,0,0
m,m,1735,16,0,40,5,11,22,78
u,u,1765,13,90,10,0,6,3,19
u,f,1902,2087,63734,9881,803,2465,2752,15901
m,f,2009,6280,235689,213100,14912,39841,100105,367958
m,m,1759,35,822,550,36,214,340,1140
f,m,1727,41,1844,366,43,260,602,1271
f,u,1896,398,79135,14771,1281,3367,8390,27809
m,f,1970,7478,541002,208595,15406,38216,88704,350921
f,u,2013,0,0,0,0,0,0,0
f,f,1777,0,0,0,0,0,0,0
f,f,1908,3056,682990,133241,10365,27018,82280,252904
f,m,1843,470,67277,8596,706,2872,7582,19756
u,f,1933,2089,46206,11392,855,2376,2613,17236
f,u,1752,13,0,137,15,56,118,326
m,f,1733,0,0,0,0,0,0,0
u,m,1777,17,0,31,2,5,1,39
m,u,1860,1071,150923,23339,2057,6267,16576,48239
f,f,2007,6584,641696,369014,24336,60318,205692,659360
f,u,1819,96,9259,2868,211,995,2482,6556
u,m,1916,5911,152813,23290,1826,6128,5691,36935
m,u,1954,17970,1437876,541266,37596,101064,264097,944023
f,m,1747,0,0,0,0,0,0,0
u,f,1753,19,1547,156,16,50,48,270
m,u,1880,770,98604,16119,1497,4434,9930,31980
f,u,1977,10933,875672,365799,27094,69671,197164,659728
u,u,1719,0,0,0,0,0,0,0
f,u,1725,4,0,76,3,51,86,216
u,m,1748,30,0,60,5,12,4,81
f,f,1982,4463,748955,286811,18379,45168,148723,499081
m,f,1829,902,139395,15839,1440,4975,12801,35055
m,f,1796,107,1701,974,88,368,746,2176
m,u,1883,644,64508,10542,1116,2837,6923,21418
m,m,1724,0,0,0,0,0,0,0
m,u,1937,14136,1117973,375827,27199,72848,184812,660686
u,f,1731,0,0,0,0,0,0,0
m,m,1987,24632,2215894,852228,53300,140500,369621,1415649
u,m,1809,223,3387,425,36,156,81,698
u,m,1770,24,1847,44,3,9,8,64
m,u,1920,7224,781490,189642,15216,42010,96251,343119
f,m,1825,759,119329,15358,1306,5132,15089,36885
u,m,1817,219,6069,723,74,293,177,1267
f,m,1841,673,130045,15689,1300,5856,13469,36314
f,m,1800,85,17294,2222,150,806,1846,5024
f,f,1815,315,95989,13410,1093,4171,11865,30539
m,u,1984,29738,1483764,667184,48517,125116,320950,1161767
m,f,1986,8507,756453,269920,18937,49324,124548,462729
u,u,1953,12836,279045,68001,4599,14963,14124,101687
m,m,1792,105,7562,1554,124,525,966,3169
u,f,1907,2623,70534,10196,832,2826,2414,16268
m,m,1760,16,21,33,4,28,44,109
f,u,2007,13113,840140,438380,28992,74972,238571,780915
u,u,1830,705,33920,2301,195,889,538,3923
f,m,1921,4884,843266,197504,15349,42789,116450,372092
f,m,1839,580,88270,12607,915,4002,11259,28783
f,m,1978,7313,707714,282273,18823,49137,137945,488178
f,f,1877,1562,301896,60038,5750,15115,46319,127222
u,f,1871,1040,35722,3833,363,1068,868,6132
u,u,1856,196,6135,321,30,125,84,560
m,f,1879,2117,287902,59879,5535,14040,34281,113735
u,m,1775,0,0,0,0,0,0,0
u,f,1735,0,0,0,0,0,0,0
u,m,1794,7,0,6,0,0,5,11
m,m,1812,439,54309,8040,526,2703,5874,17143
m,m,1746,0,0,0,0,0,0,0
u,f,1894,2473,75355,8732,761,2527,2487,14507
f,u,1710,0,0,0,0,0,0,0
m,f,1855,2170,318550,48625,3782,12893,31411,96711
m,u,1807,85,8505,2070,201,689,1719,4679
m,m,1880,7089,1047165,162901,13169,43193,102653,321916
u,m,1888,5211,177230,18000,1558,5268,4071,28897
u,u,1917,1977,66133,10129,761,2466,2034,15390
u,f,1906,2856,89140,12883,969,2975,2990,19817
f,u,2008,7700,471965,264597,19419,49817,145453,479286
f,u,2010,659,40616,15917,1208,2909,8577,28611
m,u,2007,33229,1788212,849907,57287,153770,408294,1469258
u,f,1841,766,26869,1979,194,748,518,3439
m,f,1776,0,0,0,0,0,0,0
u,f,1877,1421,54117,6943,561,1868,1929,11301
f,u,1970,12950,1091946,411648,31073,81892,235158,759771
m,m,1976,21171,1748540,664109,41652,111322,303840,1120923
f,m,1853,1470,121902,17071,1615,5347,13637,37670
m,m,1937,16873,1580762,532301,38511,97764,246955,915531
f,m,1909,3812,651012,128604,9931,29351,77229,245115
f,u,1966,9227,784205,312414,23261,59143,173504,568322
f,u,1885,205,21041,3367,381,883,2606,7237
f,f,1709,0,0,0,0,0,0,0
m,m,1727,106,6440,1054,102,450,816,2422
u,f,1824,301,13949,1082,88,431,177,1778
u,m,1872,3537,81019,7470,751,2421,1750,12392
m,f,1783,0,0,0,0,0,0,0
f,m,1918,3581,521856,124128,9659,25372,71015,230174
f,m,1733,2,0,1,0,0,0,1
f,u,1704,0,0,0,0,0,0,0
u,f,2004,5390,100801,35397,2505,6373,7991,52266
u,f,1797,87,3573,691,59,207,144,1101
f,u,1833,87,10656,2020,174,704,2116,5014
m,f,1961,5078,436954,170970,12771,30454,78143,292338
f,u,1741,17,1909,302,17,100,397,816
m,u,1777,0,0,0,0,0,0,0
u,u,1727,0,0,0,0,0,0,0
f,u,1786,0,0,0,0,0,0,0
m,m,1877,4462,709847,100133,8683,26431,64304,199551
m,u,2008,18845,887209,468960,33750,89994,225992,818696
u,u,1935,7904,167624,41320,3062,8842,9058,62282
u,f,1979,4483,125335,38653,2117,6676,9036,56482
f,f,1776,0,0,0,0,0,0,0
u,f,1742,0,0,0,0,0,0,0
f,m,1796,143,13381,2458,224,1038,3315,7035
f,m,1998,6688,477918,236864,15651,41666,132210,426391
f,m,1741,51,45,1923,154,619,1368,4064
m,u,1711,0,0,0,0,0,0,0
u,u,1786,0,0,0,0,0,0,0
m,u,1838,257,22463,3071,228,983,2447,6729
u,u,1959,15002,311292,76087,4983,16783,15471,113324
m,u,1760,25,221,308,36,132,321,797
m,f,1825,433,74095,11351,919,3236,7577,23083
m,u,1809,51,2053,843,83,296,672,1894
f,f,1809,295,57536,9582,919,3274,8879,22654
f,u,1973,8548,498463,259335,20826,51491,143886,475538
f,u,1855,602,126096,20903,1856,6059,17173,45991
f,m,1948,5434,608494,213935,15697,39251,110519,379402
m,u,1756,0,0,0,0,0,0,0
m,m,1978,24501,2178188,817241,51655,133915,354103,1356914
m,f,1859,1347,191343,30937,2827,8419,21968,64151
f,m,1822,239,19170,4443,394,1369,4130,10336
u,m,1936,6511,102106,27581,2101,6534,6480,42696
m,u,1927,14149,825176,288643,23001,64416,157957,534017
m,u,1959,21066,1387921,490150,35554,99255,249114,874073
u,u,1928,11427,189599,48351,3494,12749,9524,74118
u,m,1934,8225,231855,45186,3158,10201,9804,68349
m,m,1715,33,407,222,16,52,170,460
m,m,2011,85,6866,2098,62,266,1015,3441
m,m,1839,2043,310326,38200,2649,11697,28324,80870
u,u,1921,2240,42948,8572,692,2174,1744,13182
m,m,1826,1942,345521,38874,2767,11286,31942,84869
f,m,1988,8221,739854,299302,19154,51954,158579,528989
f,m,1920,4939,824948,199565,16153,41457,113866,371041
m,m,1785,79,7879,2123,181,840,1636,4780
f,u,1989,14407,868994,436741,31200,79660,242642,790243
f,m,1808,151,13069,2998,290,1179,3765,8232
f,f,1746,0,0,0,0,0,0,0
u,f,1911,2807,86138,13650,1092,3354,3469,21565
m,u,1842,207,25510,2881,262,837,2401,6381
u,u,1726,0,0,0,0,0,0,0
f,f,1954,3301,481253,180689,12307,30886,94571,318453
f,u,1881,329,38540,7036,684,1863,4882,14465
f,u,1924,4193,413330,143815,11822,30691,86493,272821
f,u,1792,0,0,0,0,0,0,0
u,m,1731,0,0,0,0,0,0,0
u,m,1767,19,7,63,4,27,7,101
f,m,1987,7670,718448,276705,18568,48164,140603,484040
u,m,1722,55,366,47,3,33,0,83
f,u,1986,12290,910747,403979,28594,75070,221868,729511
m,u,1879,1205,199267,33934,3058,8785,20899,66676
u,f,1825,147,2856,381,38,147,84,650
u,f,1732,0,0,0,0,0,0,0
u,m,1841,1081,39828,3083,220,1205,662,5170
m,u,1982,31219,1818554,723279,53115,138884,350285,1265563
m,f,1909,5989,780866,154352,12382,34398,78546,279678
u,u,1733,0,0,0,0,0,0,0
m,m,1863,2489,325438,50850,4490,14213,33550,103103
f,f,1875,2194,430754,87659,7884,21278,66907,183728
m,m,2009,12600,688900,430156,26479,71544,189247,717426
m,m,1990,28393,2554295,923800,58202,156205,413440,1551647
f,f,1841,1075,176169,31855,3001,10462,28920,74238
f,m,1766,10,0,27,5,15,48,95
u,m,1802,14,714,38,6,15,3,62
f,u,1796,2,0,3,0,0,4,7
f,f,1727,8,2195,127,7,83,148,365
f,f,1719,20,0,197,25,199,364,785
m,m,1856,3692,455852,68083,5544,19203,43710,136540
u,u,1880,275,4725,614,64,181,169,1028
m,u,1960,23764,1881958,714165,47968,135846,355183,1253162
f,u,1917,1271,183718,41491,3382,9986,25717,80576
m,f,1977,6000,478775,177148,13406,33345,79667,303566
u,m,1896,9622,310368,32692,2642,9802,6759,51895
m,f,1771,18,729,35,3,16,48,102
u,f,1761,0,0,0,0,0,0,0
f,m,1965,6459,522298,201585,13900,36368,101535,353388
f,m,1961,6875,618284,244345,17785,45669,121412,429211
f,m,1903,3117,502353,100003,7343,23115,63064,193525
m,m,1965,22089,1796299,672427,43395,114299,308259,1138380
m,m,1878,5793,617741,108857,9693,29178,69541,217269
f,f,1911,3472,775382,147579,11508,30879,90912,280878
m,f,1888,3927,479235,96408,8877,23627,55801,184713
f,u,1739,0,0,0,0,0,0,0
f,f,1793,49,6871,1204,100,547,1493,3344
f,u,1763,0,0,0,0,0,0,0
f,m,1982,6683,683357,261898,17121,45438,126817,451274
f,u,1948,7393,679300,264350,21400,52800,147488,486038
u,f,1995,5608,86640,28634,1988,6042,7062,43726
m,f,1767,0,0,0,0,0,0,0
u,m,1793,32,0,26,3,8,7,44
f,m,1917,3781,625139,143650,11228,30456,84165,269499
f,f,1780,0,0,0,0,0,0,0
u,f,1977,3091,83771,22922,1446,3920,4703,32991
u,u,1815,123,5449,680,59,271,314,1324
m,u,1901,3366,425290,78723,6283,18792,41765,145563
m,u,1764,0,0,0,0,0,0,0
m,u,1994,37034,1913545,863123,63581,164873,417931,1509508
u,f,1929,2847,63180,18261,1526,3773,3667,27227
u,m,1892,6222,194634,21096,1775,6629,4242,33742
f,f,1834,726,202689,27847,2306,7993,23757,61903
u,m,1962,9390,153473,46142,2905,9064,8403,66514
u,f,1940,2160,58613,11977,858,2668,2531,18034
m,u,1942,13306,1035568,351307,24774,64000,161520,601601
m,f,1939,4445,458783,154578,10941,28828,71201,265548
m,u,1933,13645,1148991,377279,28128,77485,189432,672324
m,f,1803,172,15090,3980,312,1379,3335,9006
f,f,1892,3450,762455,151079,14001,34299,104021,303400
f,f,1827,789,191456,29580,2237,9723,23956,65496
f,f,1767,0,0,0,0,0,0,0
f,m,1826,489,93092,10641,800,3268,10460,25169
f,f,1715,0,0,0,0,0,0,0
f,f,1839,590,108384,17464,1509,5063,16527,40563
f,f,1861,840,142632,23671,2350,6405,18694,51120
f,m,1946,5869,627422,220247,16015,39699,110545,386506
m,f,1988,12994,1297732,440789,30252,79390,208171,758602
u,m,1992,9171,121028,41413,2942,8493,9253,62101
u,m,2006,10989,134846,53954,3395,10576,11819,79744
u,u,2006,20214,363576,128671,8461,24548,29158,190838
u,m,1772,66,482,46,9,20,13,88
f,m,1817,131,15917,2697,234,854,2115,5900
u,m,1923,6646,127767,32021,2406,7922,7171,49520
f,f,1774,12,111,118,11,69,124,322
u,m,1810,342,6050,785,82,264,219,1350
f,f,1737,0,0,0,0,0,0,0
u,f,1905,1842,53248,6960,503,1765,1689,10917
u,f,1853,517,21272,1712,181,580,361,2834
f,u,1768,0,0,0,0,0,0,0
u,m,1968,13447,215531,69849,4408,13851,13922,102030
m,u,1828,349,32670,4594,474,1367,3004,9439
f,f,1889,3057,701095,130150,11976,29921,91322,263369
f,f,1995,5880,641707,316320,20226,51364,165999,553909
m,u,1781,11,203,116,11,47,105,279
m,f,1791,134,20159,4005,316,1292,2708,8321
u,m,2010,83,257,360,29,41,47,477
m,m,1875,2844,429864,74354,6399,18884,44568,144205
u,m,1975,10690,187493,53229,3283,10230,10531,77273
m,u,1768,5,163,41,3,25,80,149
f,m,1778,0,0,0,0,0,0,0
f,u,1906,895,152602,29285,2324,7023,17212,55844
m,u,1726,0,0,0,0,0,0,0
m,m,1908,11039,1652739,342065,24340,73402,178191,617998
m,u,1874,393,49669,8199,701,2185,5404,16489
u,m,1863,1238,38483,3522,344,1311,805,5982
m,f,1928,4832,406006,147710,11805,30285,72599,262399
u,u,1762,0,0,0,0,0,0,0
u,u,1951,11232,225697,59171,4178,12670,11844,87863
m,u,1936,16429,1114495,369412,28669,71984,196213,666278
u,m,2009,7059,105344,42362,2613,7660,8453,61088
f,f,1886,3028,619757,117697,10705,26914,84503,239819
m,m,1802,19,1725,460,26,133,483,1102
m,m,1837,2255,411025,50456,4033,14820,37612,106921
u,u,1896,508,10392,1499,108,407,348,2362
u,f,1966,2599,49439,15772,1126,3206,3468,23572
u,f,1885,1605,43795,6459,631,1851,1683,10624
u,m,1853,2124,48311,5886,476,1990,1527,9879
u,m,1804,362,9317,737,89,291,134,1251
u,m,1972,9949,184211,52345,3466,10048,11039,76898
u,f,1774,23,0,16,0,4,5,25
u,m,1918,5739,160585,24156,1878,5772,4949,36755
u,u,1876,346,10950,1170,127,387,330,2014
m,u,1899,1385,147106,27493,2203,6465,15686,51847
u,m,1925,6779,139214,31739,2374,7237,7001,48351
u,u,1925,9217,214144,43310,3228,11367,8702,66607
m,m,1779,0,0,0,0,0,0,0
m,u,1772,0,0,0,0,0,0,0
m,m,1758,0,0,0,0,0,0,0
m,m,1982,22956,2277030,793416,49207,131435,349385,1323443
f,m,1829,1055,190818,19902,1546,5811,19876,47135
f,f,1730,0,0,0,0,0,0,0
u,m,1815,232,2948,223,34,88,67,412
m,u,1853,587,69493,11109,984,3218,7505,22816
u,f,1744,0,0,0,0,0,0,0
f,u,1886,422,60000,12545,1227,3239,10230,27241
f,f,1987,5921,889741,353857,23769,58294,192132,628052
m,f,1917,6053,873933,187327,14283,39578,92951,334139
u,m,1887,4443,137613,17011,1457,4451,3552,26471
u,m,1718,0,0,0,0,0,0,0
m,f,1841,1761,216692,36488,3104,11038,26975,77605
m,f,1863,1846,303935,54281,4726,14304,33251,106562
m,m,1834,2720,494168,46523,3458,13722,37627,101330
f,f,1792,46,3661,1705,136,616,2271,4728
m,u,1886,978,93166,18083,1683,4764,11758,36288
m,f,1785,82,834,636,51,218,545,1450
f,m,1893,3869,615854,109877,9523,28663,71944,220007
m,f,1732,0,0,0,0,0,0,0
m,u,1710,0,0,0,0,0,0,0
m,u,1996,35186,1778526,742602,55413,148114,365114,1311243
f,m,1732,0,0,0,0,0,0,0
m,f,1978,6435,582591,218706,16036,40044,105428,380214
u,f,1943,2660,80955,16507,1036,3558,3682,24783
m,m,1768,54,743,378,69,125,275,847
m,f,1817,597,104724,19015,1319,5283,16082,41699
m,f,1726,0,0,0,0,0,0,0
u,f,1792,50,2779,217,21,79,47,364
f,u,1799,0,0,0,0,0,0,0
u,m,1986,11926,244661,63748,3990,11799,12741,92278
f,m,1911,4652,865478,165367,12852,36333,98570,313122
u,m,1843,822,24990,2060,184,718,353,3315
f,f,1880,2295,453786,106703,9486,25557,78503,220249
m,m,1794,15,406,51,7,29,58,145
u,m,1850,1938,73241,5790,486,2058,1344,9678
u,m,1989,15096,312215,80481,4970,14748,16486,116685
m,f,1915,6874,972176,197649,15176,44075,102542,359442
f,u,1935,4834,512981,190841,14949,36775,113451,356016
m,f,1805,75,9695,2420,161,759,2077,5417
u,f,1987,5757,171682,40799,2432,7428,9539,60198
u,m,1950,10566,290288,64060,3600,12098,12522,92280
u,f,1764,0,0,0,0,0,0,0
f,f,1850,806,264594,39052,3374,10915,31702,85043
u,f,1889,2535,95115,10669,952,3110,2608,17339
u,f,1857,736,17206,2166,221,726,513,3626
f,m,1932,4731,503236,189013,15061,37405,101929,343408
m,m,1729,0,0,0,0,0,0,0
u,m,1924,6814,123533,26671,1999,6592,6420,41682
u,f,1788,0,0,0,0,0,0,0
f,u,1859,293,34259,7911,672,2069,6441,17093
f,u,2012,0,0,0,0,0,0,0
f,u,1895,415,55861,12222,1027,2873,9542,25664
u,u,1799,0,0,0,0,0,0,0
m,f,1778,0,0,0,0,0,0,0
u,u,1742,0,0,0,0,0,0,0
m,u,1868,1049,149271,28350,2093,7280,16033,53756
m,u,1975,29286,1673322,665040,50249,133032,329420,1177741
f,m,1928,4706,512657,169958,13702,35616,95335,314611
m,m,1712,0,0,0,0,0,0,0
u,f,1957,2617,64019,18904,1404,3725,3796,27829
f,m,1783,2,31,8,2,1,13,24
f,f,1867,1748,398230,71855,6985,17381,52904,149125
m,m,1876,4540,723542,114080,9710,30205,72789,226784
m,f,1930,4684,388496,146618,11292,30526,69503,257939
u,f,1964,2691,42560,15984,1221,3118,3656,23979
f,f,1837,413,92468,13979,1223,4129,13377,32708
f,m,1980,6975,689176,259222,17636,45654,126821,449333
u,u,1840,174,5420,498,53,150,87,788
f,m,1979,6444,626961,237970,16452,41515,123218,419155
f,m,1876,1482,292431,50975,4362,13532,40115,108984
m,u,1712,0,0,0,0,0,0,0
u,m,1837,1139,49394,3694,303,1323,758,6078
m,u,1816,196,14770,2674,233,910,2230,6047
u,m,1751,148,5167,212,22,134,40,408
