chargender,authgender,date,characters,speaking,agent,mod,patient,poss,total
u,m,1902,2673,67273,10785,868,3094,2273,17020
u,m,1835,990,38203,3068,301,1006,701,5076
m,f,1795,114,9836,2502,172,777,1523,4974
u,u,1741,10,266,55,6,15,8,84
m,m,1997,23590,1773508,752717,47437,131189,350499,1281842
f,u,1815,219,29581,5144,493,1525,4194,11356
m,f,1741,0,0,0,0,0,0,0
m,m,1798,162,29143,3697,270,1408,3306,8681
m,u,1833,164,17625,3102,245,916,2169,6432
u,f,1773,0,0,0,0,0,0,0
m,m,1791,52,5371,854,70,287,851,2062
u,u,1865,287,8431,1001,105,319,370,1795
f,u,1862,328,73930,11494,988,2704,8083,23269
f,m,1785,56,6824,4855,381,1856,4067,11159
m,m,1887,5574,747474,149637,12445,34893,84738,281713
f,f,1952,2996,377430,144279,10766,26043,75986,257074
u,f,1778,0,0,0,0,0,0,0
m,m,1929,14544,1216226,441508,32365,89841,220667,784381
f,f,1991,5569,550991,290023,20079,48353,150320,508775
m,m,1803,305,11096,2274,220,886,1581,4961
f,f,1826,313,74829,10542,879,3323,10310,25054
f,f,1941,2733,402425,130068,9414,23278,71620,234380
u,m,1971,10220,154466,47807,3334,9490,9505,70136
u,u,1971,18038,387241,95761,6332,20736,20595,143424
u,u,1768,11,49,22,0,4,4,30
f,f,1946,3369,467320,160713,11701,27104,84539,284057
f,m,1964,5555,466935,203738,14881,37175,101625,357419
m,u,1934,11757,745946,286499,21872,57454,147324,513149
m,u,1856,609,88144,9828,887,2843,7150,20708
u,f,1833,610,21045,1635,155,690,478,2958
f,m,2003,7098,588782,272212,17851,46566,141917,478546
u,m,1831,1839,72227,4320,333,1394,1036,7083
f,u,1813,33,7042,1787,146,574,1660,4167
m,u,1957,22427,1813743,637376,47590,121199,299431,1105596
u,u,1892,606,15303,1975,172,596,649,3392
f,u,1851,176,22514,3570,337,1001,3458,8366
u,u,1994,24447,387507,125151,9302,26641,28707,189801
f,f,1794,86,5300,1636,193,708,2161,4698
u,u,1709,0,0,0,0,0,0,0
m,m,1846,2893,460326,58198,4203,17881,43183,123465
f,m,1993,6262,438584,218943,14604,38512,112266,384325
m,u,1885,455,50513,7558,716,1983,4894,15151
u,f,1844,620,13211,1753,181,627,394,2955
u,u,1712,0,0,0,0,0,0,0
u,f,1826,351,18769,1509,126,462,522,2619
f,f,2002,6309,586105,306905,20665,49861,164993,542424
f,f,1806,149,20479,5610,466,2015,5922,14013
u,f,1946,3061,54154,14526,1127,3077,2880,21610
f,m,1776,0,0,0,0,0,0,0
m,u,1770,0,0,0,0,0,0,0
m,u,1887,460,58308,10117,894,2474,6652,20137
m,m,1767,75,1650,840,54,211,615,1720
u,f,1777,0,0,0,0,0,0,0
f,f,1729,0,0,0,0,0,0,0
u,f,1849,545,14855,1487,135,454,495,2571
f,f,1916,2559,675128,133753,10006,26316,79471,249546
u,f,1754,0,0,0,0,0,0,0
u,u,1964,18618,342323,97442,6596,20363,19118,143519
u,f,1775,3,0,2,0,1,1,4
u,f,1782,0,0,0,0,0,0,0
f,f,1778,0,0,0,0,0,0,0
u,m,1729,0,0,0,0,0,0,0
u,f,1728,0,0,0,0,0,0,0
u,f,1910,2117,68591,9684,855,2515,2340,15394
f,u,1972,9472,796320,308152,23526,61272,177187,570137
f,m,2010,73,4265,3635,264,561,1795,6255
u,m,1723,0,0,0,0,0,0,0
u,u,2005,20800,345417,118153,8180,23599,26962,176894
f,m,1977,5011,340880,159002,11081,28110,81233,279426
m,m,1814,21,205,149,9,37,85,280
f,m,1953,5084,540889,200302,13975,35773,97637,347687
u,f,1893,2448,85194,9681,906,2718,2456,15761
f,u,2002,10425,752189,324648,22821,60145,188534,596148
f,f,1965,2190,229267,102541,7623,18483,51568,180215
f,f,1723,0,0,0,0,0,0,0
u,u,1841,83,1964,208,18,82,53,361
m,m,1911,10788,1672595,318204,22662,72227,164864,577957
m,u,1878,600,73930,14692,1084,3571,7920,27267
u,f,1770,51,0,120,13,55,25,213
u,m,1996,10610,164399,51091,3259,9924,11947,76221
f,f,1817,368,95189,13103,1092,4201,13980,32376
f,m,1981,5785,480711,222295,15539,38646,113011,389491
u,f,1716,0,0,0,0,0,0,0
m,u,1755,0,0,0,0,0,0,0
u,u,1802,20,664,39,1,19,11,70
u,u,1819,95,779,424,44,202,85,755
u,u,1831,126,5322,289,32,101,49,471
m,f,1982,6686,439110,195839,14673,36450,89057,336019
m,f,1711,0,0,0,0,0,0,0
f,f,1866,1417,379688,61915,6013,15233,47960,131121
u,f,1965,2664,57460,16140,1063,3211,3370,23784
f,f,1907,2227,518712,106062,8035,20779,64149,199025
f,m,1960,5431,461268,186822,14224,34564,94388,329998
m,u,1912,5699,519299,123363,8802,29074,66618,227857
m,f,1729,0,0,0,0,0,0,0
f,u,1812,78,8021,2705,239,813,2326,6083
u,m,1998,10323,191918,53728,2984,9887,11842,78441
f,f,1922,3758,763692,176003,13986,35616,106575,332180
m,f,1813,562,86363,12784,1001,4065,12437,30287
f,m,1904,2092,323327,65425,4838,15358,40061,125682
m,u,1977,30525,1748850,731553,52376,140386,353566,1277881
f,m,1803,124,4626,1517,172,625,1850,4164
f,u,1743,0,0,0,0,0,0,0
m,m,1991,21305,1310423,620214,41183,106873,285459,1053729
u,m,1946,8063,166818,41151,2703,7903,8447,60204
u,u,2000,19465,308937,100408,6882,20367,22830,150487
m,m,1861,1622,238577,37435,3092,9647,22821,72995
u,f,1858,844,23419,3312,308,932,672,5224
u,f,1988,5168,97490,38513,2431,6961,8983,56888
f,u,1904,1157,179897,34681,2885,8164,23271,69001
u,f,1781,36,1370,112,12,46,12,182
f,m,1870,1251,234939,39203,3402,10697,28614,81916
u,m,1781,190,927,235,31,80,49,395
u,u,1759,0,0,0,0,0,0,0
f,u,1720,0,0,0,0,0,0,0
m,m,1806,303,32940,4928,436,1537,4265,11166
f,u,1943,4609,436460,157671,11678,28423,80217,277989
m,f,1993,9509,584628,276760,19071,50973,131376,478180
u,f,1755,0,0,0,0,0,0,0
m,m,1995,20789,1674494,659003,40967,111166,303213,1114349
f,m,1834,646,154450,15442,1291,4779,14212,35724
u,f,1759,77,582,167,10,101,48,326
f,m,1791,48,1536,392,38,199,461,1090
u,f,1936,2735,48486,12526,960,2897,2956,19339
f,u,1703,0,0,0,0,0,0,0
u,m,2004,11577,166687,57110,3898,11066,12987,85061
m,m,1916,9335,1338901,291569,21141,63703,147869,524282
m,u,1882,1968,155369,25411,2252,6649,17128,51440
m,u,1921,4065,474295,108819,8076,23375,52317,192587
m,m,1778,0,0,0,0,0,0,0
m,f,1904,3171,366363,72979,5344,16532,41132,135987
f,m,1924,4421,541945,188991,14139,36853,106964,346947
f,u,1784,16,1550,105,13,49,110,277
u,u,1770,0,0,0,0,0,0,0
f,f,1802,149,23211,4420,468,1715,4354,10957
u,m,1836,1175,41697,3303,288,1123,682,5396
f,u,1902,1070,161315,29725,2243,6563,20026,58557
m,f,1802,138,17685,3189,316,1031,2500,7036
f,u,1866,227,50826,7335,680,1919,5163,15097
u,u,1983,24297,439564,123558,8095,24671,26100,182424
m,m,1723,0,0,0,0,0,0,0
m,u,1728,0,0,0,0,0,0,0
f,f,1979,3573,387943,185838,13892,32740,100143,332613
u,u,1901,1601,31905,5934,504,1675,1406,9519
u,f,1967,2436,34774,11880,877,2494,2239,17490
m,m,1862,2167,253104,42605,3664,11275,29534,87078
u,m,1711,0,0,0,0,0,0,0
m,u,1844,264,27326,5861,398,1749,4364,12372
u,f,1884,1826,48146,6530,624,1918,1611,10683
u,m,1928,7424,128595,32528,2428,7964,6936,49856
m,m,1730,0,0,0,0,0,0,0
u,f,1819,164,1145,599,74,241,122,1036
u,m,1967,10692,182293,56430,3595,11313,11687,83025
m,f,1997,13169,889892,397235,27800,72783,192666,690484
f,f,1821,309,101803,19079,1472,5123,17638,43312
m,f,1721,0,0,0,0,0,0,0
m,u,1703,0,0,0,0,0,0,0
f,m,1950,5459,607448,210613,14372,37086,104858,366929
u,u,1988,22255,357621,114869,7940,23251,24518,170578
m,m,1790,50,1036,235,18,89,155,497
f,m,1729,0,0,0,0,0,0,0
f,m,1840,883,107969,19533,1665,6553,16763,44514
f,u,1822,110,23404,3496,174,1402,4370,9442
f,u,1938,3913,398778,156084,10933,28002,84726,279745
f,f,1785,64,2217,999,101,388,1028,2516
u,m,1745,0,0,0,0,0,0,0
m,f,1948,4794,507457,172515,12779,31845,76785,293924
m,u,1945,15942,1217534,420964,30687,74731,195806,722188
m,u,1931,15479,1152815,403534,30502,83756,212333,730125
m,m,1930,15236,1508416,481400,35728,95328,244168,856624
u,u,1955,15469,367460,81316,5663,17708,16567,121254
f,u,1848,185,18323,3227,353,1113,3118,7811
m,f,1871,2369,354749,62768,5558,15846,38004,122176
u,f,1944,2215,34124,9190,766,2086,2183,14225
f,f,1953,2783,375825,144246,9764,23877,71778,249665
m,m,1974,18822,1167223,541813,35343,93788,250377,921321
m,u,1967,36120,2316649,890597,65313,180026,446766,1582702
u,m,1732,0,0,0,0,0,0,0
u,u,1887,186,4385,482,34,141,133,790
u,m,1788,92,89,163,11,49,28,251
m,f,1911,4971,688361,142776,11079,31323,72022,257200
m,u,1754,0,0,0,0,0,0,0
f,u,2001,10404,757636,338999,22792,59594,197620,619005
m,u,1910,4466,528476,103222,6919,25622,51313,187076
u,u,1832,507,14230,1205,103,389,396,2093
f,m,1971,5642,375998,171155,12540,31833,89836,305364
u,u,1803,90,760,100,15,36,17,168
f,m,1915,3141,539845,120299,9213,25845,69353,224710
u,f,1721,0,0,0,0,0,0,0
u,m,1768,23,0,14,5,1,5,25
f,u,1871,259,43392,7190,736,1743,4802,14471
u,f,1746,0,0,0,0,0,0,0
m,m,1850,3896,646396,81503,6539,24919,57677,170638
f,u,1787,15,1147,245,26,108,283,662
m,f,1932,3761,329828,127729,9918,25515,64446,227608
u,f,1813,239,17568,1558,99,631,507,2795
f,m,1907,2935,493131,94351,7176,20884,57370,179781
m,u,1987,29189,1419121,656836,47985,123269,313451,1141541
m,u,1775,0,0,0,0,0,0,0
u,f,1958,2606,44364,13880,1035,2940,3005,20860
f,u,1981,11155,826988,351563,26887,66749,190694,635893
u,f,1890,2339,84685,9308,901,2933,2150,15292
m,m,1871,3265,466008,81054,7020,21039,51167,160280
f,f,1712,0,0,0,0,0,0,0
m,f,1924,3078,242284,89480,7071,18488,47166,162205
m,m,1867,2870,446904,70808,6520,18535,42976,138839
f,m,1930,4973,556998,180870,14603,37579,103045,336097
u,f,1836,384,9188,1304,119,484,307,2214
f,u,1769,21,641,315,37,209,400,961
f,m,1828,455,67348,8161,740,2760,8440,20101
u,u,1958,13906,322966,91899,5924,18097,17746,133666
f,f,1854,1148,261308,46837,4310,12400,36520,100067
m,m,1828,1272,201049,20992,1678,6999,18236,47905
m,f,1979,7016,473893,202542,14545,37191,93398,347676
u,u,1961,19218,368060,103669,7520,21947,21848,154984
u,u,1825,199,4193,411,51,138,137,737
u,f,1793,28,5135,413,18,120,114,665
m,m,1860,3422,512007,71891,6207,21186,49966,149250
u,u,1977,20076,320114,98034,7504,21110,20719,147367
u,m,1977,8728,165720,47915,3085,8779,9509,69288
f,f,1862,864,183082,29364,2781,7797,23266,63208
f,f,1714,0,0,0,0,0,0,0
m,f,1706,0,0,0,0,0,0,0
f,m,1795,28,7071,814,69,283,1103,2269
u,f,1873,1121,29042,3643,402,1040,833,5918
f,u,1913,1418,203819,41133,3423,10087,23644,78287
m,u,1829,125,24355,4193,397,1288,2785,8663
u,u,1864,297,6128,577,70,177,169,993
m,f,1804,179,8470,3836,400,1074,2710,8020
f,f,1753,34,2148,605,75,411,702,1793
u,u,2007,21367,373658,123653,7905,24676,27566,183800
f,f,1846,650,170315,24161,2103,7136,20396,53796
m,u,1956,21510,1748386,631720,44874,119912,301251,1097757
u,u,1749,0,0,0,0,0,0,0
u,m,1749,120,731,138,16,84,26,264
f,m,1938,3418,338395,129159,9847,24250,64802,228058
m,m,1936,12128,1064746,382389,27721,72233,188334,670677
f,f,1929,2537,330465,130491,10274,24519,76651,241935
u,u,1715,0,0,0,0,0,0,0
u,m,1730,0,0,0,0,0,0,0
u,u,1923,12857,311720,63209,4176,15258,13303,95946
f,f,1791,96,20087,3576,279,1369,3313,8537
m,f,1955,5569,505685,179866,12535,32988,81110,306499
f,f,1992,5555,612240,309537,19540,48636,159728,537441
m,m,1809,346,21085,4916,372,1616,3521,10425
f,u,1979,11147,910556,360792,27656,68972,202036,659456
u,f,1970,3631,48937,14467,1180,3279,3357,22283
u,f,1955,2307,39631,11126,804,2354,2218,16502
u,u,1996,23157,374546,111638,7635,23634,26609,169516
u,m,1774,49,2087,236,16,60,51,363
f,f,1887,2314,479375,94204,8746,22344,67981,193275
f,m,1722,5,0,0,0,4,1,5
f,m,1818,196,28378,3216,276,938,2660,7090
f,f,1708,0,0,0,0,0,0,0
u,f,1710,0,0,0,0,0,0,0
f,m,1751,41,0,210,20,147,288,665
m,u,1872,914,89420,20830,1991,5267,13708,41796
u,m,1905,2921,95131,12708,847,3370,2328,19253
m,u,1800,15,602,110,6,44,104,264
f,u,1998,12433,814380,386369,27720,70124,218291,702504
f,u,1963,8068,717790,267177,19716,51360,148647,486900
m,m,1945,12444,1016408,368798,25149,60636,159058,613641
u,f,1823,276,9522,1035,86,312,190,1623
u,f,1897,2381,92600,10660,928,2973,2770,17331
f,m,1871,1122,167303,35502,3084,9985,27005,75576
u,f,1812,201,3465,691,60,286,212,1249
u,u,1984,19782,388432,101223,6544,23405,20132,151304
f,u,1949,5819,514651,201891,14537,36513,105317,358258
m,f,1854,1664,223072,43584,4109,11717,30062,89472
u,u,2003,17575,331052,101840,6855,20133,22066,150894
f,f,1968,2644,292068,133370,9257,23199,68857,234683
u,u,1845,270,9368,941,70,292,149,1452
m,u,1839,559,81659,10325,729,3462,7474,21990
u,f,1978,2893,58642,19251,1200,3591,4775,28817
f,u,1818,97,11603,2544,295,883,2926,6648
m,f,2003,12008,786602,387470,28338,71044,178489,665341
u,f,1887,2472,99661,10605,925,3243,2419,17192
m,u,1925,12711,981460,316451,24425,71608,176331,588815
u,m,2000,12501,211327,68850,4651,13864,14705,102070
u,m,1990,11991,196062,60818,3667,11289,12515,88289
u,f,1975,2782,62753,15307,981,2930,3433,22651
f,u,1789,35,3890,721,112,398,941,2172
f,u,1890,348,49420,8127,775,2073,5722,16697
u,f,1997,6326,116685,34155,2155,6147,8623,51080
m,u,1857,992,118971,20205,1834,5343,14401,41783
m,u,1951,19622,1657428,634753,47037,123612,310245,1115647
u,u,1900,16941,442824,74799,5378,19419,14634,114230
f,f,1950,2781,381185,156290,10862,25953,77748,270853
m,f,1873,2618,398762,71384,6505,17729,40349,135967
u,f,1868,1010,30998,3106,316,960,751,5133
u,f,1804,97,5046,317,28,132,33,510
u,f,1708,0,0,0,0,0,0,0
f,u,1755,0,0,0,0,0,0,0
u,m,1733,24,0,30,3,5,2,40
u,f,1986,3317,61374,19947,1252,3637,4517,29353
u,f,1925,1431,26311,8306,698,1844,1966,12814
m,f,2010,6,0,60,2,8,54,124
f,f,1985,3809,406453,209659,13980,34121,111644,369404
m,m,1957,15284,1417713,526415,33311,87660,224741,872127
m,u,1944,11946,772371,272683,19497,50062,131188,473430
m,f,1951,5710,477341,179094,13283,32675,82296,307348
u,f,1815,376,23737,1977,154,651,352,3134
f,f,1905,1700,346700,67947,4982,13785,41974,128688
m,m,1899,17296,2080792,363309,28458,88938,208598,689303
m,u,1704,0,0,0,0,0,0,0
u,f,1807,243,2665,739,42,343,133,1257
m,f,1723,0,0,0,0,0,0,0
u,m,1857,2308,92271,8212,683,2854,1608,13357
u,u,1857,353,9297,949,94,302,181,1526
f,m,1706,0,0,0,0,0,0,0
u,f,1784,11,1107,22,2,3,0,27
u,f,1796,98,178,175,26,58,33,292
m,m,1996,20472,1461537,622904,38346,105103,285459,1051812
u,m,1864,1673,47538,4289,476,1504,1256,7525
f,m,2005,6972,508835,254761,16596,44513,135008,450878
m,f,1938,5841,458953,172844,13794,34624,85696,306958
m,m,1866,5147,903077,149886,11766,36926,90158,288736
f,m,1745,0,0,0,0,0,0,0
f,u,1765,8,31,82,11,20,64,177
m,f,1972,3586,222044,106779,7844,19556,47847,182026
f,u,1821,112,19897,5214,411,1681,5451,12757
f,f,1879,1317,321592,63368,6190,14133,44170,127861
u,u,1776,0,0,0,0,0,0,0
m,m,1922,15204,1806126,451515,33115,92848,226603,804081
m,u,1847,259,37572,4492,351,1864,3717,10424
f,m,1813,68,3138,394,36,182,422,1034
m,f,1835,2638,351867,56949,5040,15716,40937,118642
m,f,1751,26,3357,1209,115,444,711,2479
f,u,1829,87,14410,2625,270,796,1941,5632
u,u,1936,10266,172442,41719,3158,9261,9296,63434
u,u,1710,0,0,0,0,0,0,0
u,f,1843,508,18598,1661,133,580,360,2734
u,u,1818,54,311,79,7,30,18,134
u,u,2009,4823,51719,22645,1653,4535,5056,33889
m,u,1986,32571,1787621,733192,53527,141072,354436,1282227
m,f,2001,11582,791728,363820,25454,66449,171735,627458
u,u,1796,23,552,25,0,8,9,42
m,u,1971,25960,1429756,583156,43085,113673,297074,1036988
u,u,1775,0,0,0,0,0,0,0
m,u,1761,0,0,0,0,0,0,0
f,u,1745,0,0,0,0,0,0,0
m,u,1715,0,0,0,0,0,0,0
f,u,1915,997,110150,25957,2085,6435,15122,49599
u,u,1978,19375,404400,105745,7119,22263,23264,158391
m,f,1870,2237,312911,60346,5525,15037,35000,115908
m,m,1841,2368,364594,47036,3549,15767,34241,100593
u,u,1990,25943,485092,141306,10115,28790,31430,211641
m,f,1749,0,0,0,0,0,0,0
u,f,1919,2070,74897,9997,786,2719,2543,16045
u,f,1848,363,11853,841,87,311,170,1409
f,f,1762,34,4099,691,84,359,1096,2230
f,f,1944,2363,336171,118143,8617,20238,61910,208908
f,u,1944,3746,310838,118511,8720,21172,64207,212610
u,m,1806,86,2463,99,21,46,52,218
m,f,1807,282,39008,11885,703,4211,10409,27208
u,u,1998,21546,376982,108149,7979,22895,26453,165476
f,f,1735,0,0,0,0,0,0,0
u,u,1827,202,4686,503,45,215,113,876
u,m,1915,4820,144373,20086,1484,5285,4328,31183
u,u,1869,155,4425,617,50,147,203,1017
u,u,1893,409,6977,1220,126,366,319,2031
u,f,1941,2105,36941,10572,742,2184,2325,15823
u,m,1903,3466,92949,13221,971,3720,2693,20605
u,f,1768,0,0,0,0,0,0,0
u,m,1889,3646,96315,10499,922,3179,2481,17081
u,m,1881,2180,63774,8344,715,2492,1710,13261
u,u,1714,0,0,0,0,0,0,0
u,u,1739,0,0,0,0,0,0,0
u,m,1758,0,0,0,0,0,0,0
f,u,1993,15235,904721,464745,33542,84671,259336,842294
m,m,1822,662,74650,10057,803,2879,7567,21306
u,u,1982,21199,406399,108371,7537,22448,22898,161254
f,u,1962,9374,841330,312295,23478,59156,167637,562566
u,u,1753,0,0,0,0,0,0,0
u,u,1829,37,639,69,10,31,37,147
m,u,1734,0,0,0,0,0,0,0
f,m,1802,11,477,213,23,110,332,678
u,f,1831,279,18765,959,90,379,264,1692
u,f,1811,90,2197,373,15,123,101,612
u,m,1844,2249,69340,5557,503,2109,1016,9185
f,f,1758,23,63,75,3,28,97,203
u,f,1928,2217,42658,11129,944,2721,2558,17352
f,f,1899,3224,713502,120964,10222,26915,81422,239523
m,m,1879,2463,317753,60575,5577,15522,37526,119200
f,f,2009,3501,193531,186214,12604,30875,103586,333279
m,m,1979,19832,1577668,614113,38659,104524,278860,1036156
m,f,1815,867,196649,22594,1680,6626,16425,47325
u,f,1989,4354,121112,30003,1696,5478,6924,44101
f,u,1737,0,0,0,0,0,0,0
f,u,1747,0,0,0,0,0,0,0
f,f,1996,7102,792329,367515,23397,59068,193458,643438
u,f,1956,2584,55444,17625,1344,3379,3383,25731
m,u,1858,1628,210036,30445,2716,7488,19219,59868
m,u,1707,0,0,0,0,0,0,0
m,f,2005,12007,802179,389503,27328,70220,183513,670564
f,m,1846,786,125213,17839,1392,5841,14872,39944
f,u,1800,5,348,27,0,7,12,46
f,f,1874,1468,336770,62479,5724,15688,43126,127017
f,m,1972,4852,331968,154184,11000,29157,79816,274157
u,f,1971,1787,22046,8002,630,1664,1946,12242
m,u,1876,825,105422,14514,1313,3867,10135,29829
f,u,1749,0,0,0,0,0,0,0
u,f,1913,2454,75739,11920,955,2935,3071,18881
u,m,1920,5554,136577,22328,1651,5929,4621,34529
m,u,1706,0,0,0,0,0,0,0
u,u,1805,10,18,23,3,6,1,33
f,m,1758,0,0,0,0,0,0,0
f,u,1870,182,39548,5786,474,1471,4838,12569
f,m,1711,0,0,0,0,0,0,0
u,f,1996,6616,111440,33497,2230,6713,8209,50649
f,m,1944,2874,278943,104265,7512,19149,52658,183584
m,m,1865,3589,542872,81035,6775,22357,51578,161745
f,m,1712,0,0,0,0,0,0,0
u,m,1922,6412,155427,26450,2052,6589,5672,40763
u,u,1780,144,1781,311,21,114,77,523
f,f,1930,2317,308214,135266,10178,25806,77987,249237
u,u,1744,5,0,10,0,0,1,11
f,u,1805,7,218,60,3,26,86,175
m,f,1837,720,88903,13890,1162,4192,11298,30542
m,u,1797,0,0,0,0,0,0,0
m,m,1953,16085,1570789,552920,36665,96136,248562,934283
u,u,1756,0,0,0,0,0,0,0
u,u,1810,111,711,155,17,72,54,298
m,u,1981,31975,1854320,713354,51297,137540,342983,1245174
u,m,1849,1310,35927,4003,306,1422,778,6509
f,u,1738,0,0,0,0,0,0,0
m,f,1971,3772,229255,109115,8048,18960,50629,186752
f,u,1929,6552,765470,237530,18195,52646,150536,458907
f,m,1749,50,4956,923,80,403,847,2253
u,f,1998,5029,96839,30233,1855,5695,7245,45028
m,u,1861,457,45330,7130,644,2138,5336,15248
f,m,1784,190,5338,1442,166,642,1752,4002
m,m,1762,168,4915,1080,66,366,889,2401
f,m,1919,3393,596123,136525,10771,28573,78399,254268
m,m,1984,18776,1340073,593140,38425,101365,269266,1002196
f,m,1807,75,8958,1528,120,516,1700,3864
f,u,1978,9259,738446,326572,23279,60376,178176,588403
f,u,1756,0,0,0,0,0,0,0
u,m,1786,47,3578,75,5,35,13,128
m,u,1744,0,0,0,0,0,0,0
m,f,1740,0,0,0,0,0,0,0
m,f,1750,0,0,0,0,0,0,0
f,m,1801,168,15717,2440,239,1154,2542,6375
u,f,1935,2820,54715,15610,1262,3528,3299,23699
f,m,1869,1316,189637,34205,3417,9136,24187,70945
u,f,1766,2,0,3,2,1,3,9
f,m,1786,41,9708,1394,143,478,1188,3203
m,m,1835,2004,303181,38734,3092,11817,31353,84996
f,u,1838,89,14606,1929,175,580,1867,4551
f,u,1857,448,79470,14108,1153,3803,11740,30804
u,m,1755,58,1304,138,17,53,28,236
f,m,1815,183,43800,3741,333,1027,3128,8229
u,f,1980,3746,63920,21547,1493,4260,5160,32460
m,f,1884,3727,470602,92798,8699,22076,54776,178349
f,m,1925,3632,460450,158224,12340,32054,95932,298550
m,f,1965,4326,386684,165652,11792,30865,74014,282323
f,f,1860,1497,305929,52524,4628,13386,40342,110880
m,m,1714,0,0,0,0,0,0,0
m,m,1919,10520,1553159,348477,25271,74317,173500,621565
u,f,1984,3192,62491,19407,1266,3714,4613,29000
f,m,1798,31,9743,1098,70,361,1335,2864
f,u,2009,3257,169268,115225,8165,21503,64238,209131
m,u,1718,0,0,0,0,0,0,0
m,f,1724,0,0,0,0,0,0,0
f,f,1936,3406,459633,169134,13234,31643,95429,309440
f,m,1902,1891,335494,61389,4696,15282,39183,120550
f,m,1762,19,855,1096,69,370,731,2266
u,f,1878,1526,44368,5360,529,1590,1543,9022
m,u,1727,0,0,0,0,0,0,0
m,m,1752,75,1482,1546,147,614,994,3301
m,m,1992,18080,1109294,525281,34941,89989,240227,890438
m,u,2013,0,0,0,0,0,0,0
m,u,2009,8845,302636,196454,14663,37381,96345,344843
m,m,1873,3019,440572,71127,5803,19194,44274,140398
f,f,1771,14,1351,93,8,46,81,228
u,m,1828,695,24116,1794,156,630,476,3056
m,u,1881,554,59812,11485,1078,2957,6669,22189
m,u,1966,26769,1959751,676915,48364,127489,332292,1185060
m,f,1818,610,69041,13633,1303,4307,10668,29911
f,f,1781,108,1272,1330,184,543,844,2901
u,f,1837,311,10048,782,74,275,232,1363
u,u,1728,0,0,0,0,0,0,0
u,u,1904,1508,38575,6037,498,1614,1177,9326
f,f,1926,2063,292776,99924,7730,19891,62191,189736
m,f,1734,0,0,0,0,0,0,0
f,u,1898,276,36975,8167,711,2000,6149,17027
f,m,1739,12,0,135,14,140,66,355
u,u,1809,13,32,15,1,5,3,24
m,u,1815,268,17470,3474,272,1098,2595,7439
u,f,1860,948,22900,3947,399,1226,1026,6598
f,f,2004,6161,631048,317615,21782,52819,170214,562430
u,m,1875,1484,52271,5637,526,1669,1276,9108
f,u,1708,0,0,0,0,0,0,0
u,m,1832,881,45011,3218,236,1071,777,5302
u,m,2005,11146,148998,55477,3982,11534,12690,83683
u,m,1776,0,0,0,0,0,0,0
u,u,1968,26100,408638,128385,9138,28944,26109,192576
u,m,1942,6030,99716,30943,2019,6488,5921,45371
u,m,1981,10416,216077,57595,4006,10905,12118,84624
m,u,2004,29223,1342640,643919,46732,123311,316581,1130543
m,m,1744,0,0,0,0,0,0,0
f,f,1984,3213,340595,167599,11182,26905,84050,289736
u,u,1905,1262,45709,5981,467,1466,1243,9157
f,f,2005,6457,697830,345389,22884,57594,190516,616383
f,m,1901,2227,406100,74239,5425,17341,46370,143375
m,m,1902,5851,723016,140779,10942,35546,77621,264888
f,f,1942,2145,380297,126501,9297,22184,67471,225453
m,u,1722,16,2159,113,5,38,29,185
u,m,1993,9851,121576,44159,3186,9122,10275,66742
f,f,1980,3531,381484,197759,13220,32807,105314,349100
u,m,1944,5211,75391,21148,1569,4856,4173,31746
u,m,1845,1112,41141,3532,283,1128,608,5551
f,f,1883,2247,454574,96007,9211,21933,68234,195385
m,f,1781,63,2215,488,59,171,250,968
m,f,1801,205,18582,4908,401,1693,3963,10965
f,m,1959,5531,539028,195264,13437,34253,98348,341302
m,f,1869,2584,352962,61415,5743,15715,36977,119850
m,u,1810,199,5901,1138,109,408,1033,2688
m,u,1898,607,73571,12566,1108,3169,7123,23966
u,m,1779,0,0,0,0,0,0,0
m,m,1985,16805,1214646,537675,34576,91496,237130,900877
f,u,1928,5049,564565,205284,16069,43433,126954,391740
f,u,1903,1347,204614,39287,3136,8824,24811,76058
m,f,1742,0,0,0,0,0,0,0
u,f,1953,2630,42615,13135,990,2856,3023,20004
u,u,1738,0,0,0,0,0,0,0
m,m,2008,17428,965785,569631,36162,96795,263059,965647
m,u,1928,14788,1040769,401830,29567,85648,222784,739829
u,m,1746,0,0,0,0,0,0,0
m,f,1925,2885,208375,89889,7264,18896,44811,160860
u,u,1980,18643,324241,100644,6831,20226,20742,148443
f,u,1782,0,0,0,0,0,0,0
f,f,1884,2010,373223,80021,7653,19095,57280,164049
m,u,1926,16010,1009848,339970,26513,77547,190328,634358
m,m,1718,0,0,0,0,0,0,0
f,u,1910,1427,219918,39238,3030,9541,22934,74743
m,m,1707,0,0,0,0,0,0,0
m,f,1962,4764,392452,160743,11321,28962,72219,273245
u,m,1954,8533,143720,41403,2692,7988,7699,59782
u,m,1834,1300,65720,3810,292,1266,792,6160
u,u,1834,289,9064,835,51,250,156,1292
u,f,1820,266,9505,1686,117,602,344,2749
u,m,1727,167,953,429,38,151,75,693
m,f,1709,0,0,0,0,0,0,0
m,f,1857,2000,289362,53251,5198,14332,35589,108370
m,u,1767,0,0,0,0,0,0,0
m,f,1950,5623,473703,188053,14008,34338,83826,320225
u,u,1758,0,0,0,0,0,0,0
u,u,1870,185,8867,604,53,159,209,1025
m,f,1762,25,6,550,80,244,471,1345
f,m,1844,1066,230336,29187,2098,10292,24219,65796
u,m,1753,19,7,47,2,33,9,91
f,f,1752,0,0,0,0,0,0,0
m,u,1743,0,0,0,0,0,0,0
f,f,1997,6957,705555,330780,21194,55389,186459,593822
u,m,1801,300,9011,940,79,360,218,1597
u,f,1963,2521,44067,14203,977,2840,3536,21556
f,f,1873,1755,442768,76078,6890,18184,55570,156722
f,f,1819,178,18458,3096,320,1056,3146,7618
m,m,1771,0,0,0,0,0,0,0
f,m,1835,571,110173,13921,1127,4428,12805,32281
m,u,1733,0,0,0,0,0,0,0
m,m,1786,79,12855,1910,201,673,1323,4107
m,m,1926,11391,1027887,332030,24864,68042,177990,602926
f,u,1920,2775,419234,92516,7554,21342,57186,178598
f,f,1801,149,19969,2819,267,1275,3439,7800
f,u,1933,5096,543394,186947,15597,38509,110997,352050
f,u,1971,9521,621967,266880,20859,52801,152323,492863
m,u,1892,977,79616,13645,1239,3575,8151,26610
u,f,1749,0,0,0,0,0,0,0
m,u,1835,404,45880,5552,391,1713,4744,12400
u,u,1989,23878,414330,131370,9300,27716,28279,196665
f,m,1772,64,111,222,38,105,276,641
f,f,1963,2195,241243,114164,7774,19173,57133,198244
m,m,2004,23201,1441365,694639,43978,117037,317339,1172993
f,u,1937,4674,484052,193558,14748,36021,111752,356079
u,m,1813,68,518,120,10,63,37,230
u,u,1920,4239,126616,19746,1529,4922,3868,30065
m,m,1989,21387,1402392,644680,40566,108778,288678,1082702
u,m,1805,106,2667,510,45,203,120,878
u,f,1725,0,0,0,0,0,0,0
u,u,1826,97,9532,489,49,135,160,833
m,u,2002,28904,1462641,622129,44481,116038,303668,1086316
m,u,1778,0,0,0,0,0,0,0
f,f,1744,0,0,0,0,0,0,0
u,m,1710,0,0,0,0,0,0,0
m,m,2005,20696,1284427,635089,41144,109509,293866,1079608
u,f,1719,61,77,121,8,37,10,176
f,m,1809,97,1008,1233,91,476,1160,2960
m,m,1942,12404,1065924,406418,27653,74144,186832,695047
f,f,1958,2307,287880,106291,7499,17917,54414,186121
u,m,1854,1702,41360,3528,354,1223,841,5946
u,u,1800,13,76,22,1,6,2,31
u,m,1760,13,0,10,1,14,1,26
u,u,1944,7561,135211,34529,2483,7485,7810,52307
m,m,1711,0,0,0,0,0,0,0
m,m,1952,16861,1520939,574922,40009,101142,255676,971749
m,m,1889,6660,799549,133664,11353,33020,78731,256768
u,f,1756,0,0,0,0,0,0,0
f,f,1897,2349,491804,95070,8298,20772,66012,190152
f,m,1742,90,11536,1521,148,490,919,3078
f,f,1759,14,2078,1143,102,480,1080,2805
m,m,1981,18870,1382331,603131,38438,99935,265665,1007169
f,f,2008,5956,447039,337269,21727,55855,179166,594017
u,m,1799,70,1343,418,36,138,100,692
m,u,1870,475,78323,12169,1064,3397,7731,24361
m,u,1943,14738,1007680,379078,26857,68126,173137,647198
m,f,1758,37,3404,708,71,434,831,2044
u,f,1969,2503,40888,14292,891,2645,2933,20761
m,u,1749,0,0,0,0,0,0,0
f,f,1718,0,0,0,0,0,0,0
m,u,1720,0,0,0,0,0,0,0
f,f,1707,0,0,0,0,0,0,0
f,f,1970,3003,276114,117648,9165,20993,57041,204847
u,f,1838,585,17158,1136,142,528,348,2154
u,u,1903,1458,25643,4127,379,1099,875,6480
u,u,1889,412,9644,1285,117,355,391,2148
m,m,1847,1737,262742,37656,2855,11270,25639,77420
u,m,1708,120,2252,173,31,121,21,346
u,f,1791,76,2645,215,25,70,28,338
m,m,2013,21,2072,1008,132,354,448,1942
f,u,1858,726,118661,21198,1938,4941,15906,43983
u,m,1878,2810,55290,7936,750,2298,1790,12774
u,f,2008,5302,66116,33034,2350,6683,8222,50289
u,u,1911,2345,32272,6203,524,1873,1243,9843
u,u,1926,10263,186552,39112,3008,10310,8401,60831
f,m,1755,91,1224,809,75,268,771,1923
m,m,1874,3554,524847,86799,7631,21985,51578,167993
f,f,1955,2834,411108,154352,10103,25076,74787,264318
f,f,1901,1987,373741,72238,6191,15190,45768,139387
f,m,1874,1066,181957,35500,3327,9445,25188,73460
u,m,1823,1000,24759,2298,204,843,511,3856
m,u,1889,839,84060,18613,1611,4541,11647,36412
u,u,1848,169,9762,542,44,250,116,952
u,m,1898,6945,240552,31336,2380,9076,6733,49525
f,u,1724,0,0,0,0,0,0,0
f,m,2001,6796,507387,236689,15727,40822,125605,418843
m,f,1944,4982,465982,154059,11396,28471,73135,267061
u,u,1774,29,747,62,2,19,14,97
f,f,1786,47,29621,3485,289,1541,3456,8771
u,f,1990,4659,88938,28314,2119,5416,6678,42527
u,m,1869,2064,46328,4980,489,1494,1172,8135
u,f,1950,2653,47380,14010,1102,2803,2783,20698
f,u,1832,433,41732,6404,576,2080,7600,16660
u,m,1912,5733,161846,24263,1900,6064,5731,37958
f,u,1776,0,0,0,0,0,0,0
f,m,1789,32,4201,1494,150,567,1717,3928
m,f,2008,11614,578738,392420,27733,73406,185591,679150
f,m,1872,2188,386953,57618,4859,15886,40107,118470
m,m,1963,17991,1209777,523689,35712,90604,231190,881195
f,m,1894,3630,580221,106764,8528,26305,68975,210572
m,f,1999,11701,770545,375967,26523,66715,167444,636649
m,m,1935,16231,1426907,511082,37641,95817,249492,894032
m,f,1812,451,81035,13453,1122,4479,10221,29275
m,f,1838,1190,158806,20932,1970,6928,17402,47232
f,m,1716,0,0,0,0,0,0,0
m,m,1849,2575,303557,44770,3719,13138,31530,93157
u,u,1824,42,443,51,3,21,18,93
u,u,1867,327,7680,689,62,240,165,1156
f,m,1984,5851,460634,210068,14254,37099,104810,366231
f,m,1790,9,0,38,1,12,75,126
f,u,1751,9,0,37,9,32,62,140
f,m,1942,3331,305751,120475,8920,23104,62433,214932
f,m,1740,25,0,296,25,133,290,744
u,u,1949,12529,217099,58157,4062,12550,10706,85475
f,u,1983,12902,909064,391050,29141,72968,208338,701497
m,m,1756,13,16,219,9,49,121,398
m,f,2000,11215,721800,375461,27469,68486,171978,643394
f,m,1750,6,0,38,3,13,45,99
u,m,1807,68,2106,319,18,84,86,507
m,m,1988,20651,1379938,602648,37897,102097,279468,1022110
f,m,1770,4,0,48,3,17,53,121
f,f,1835,1695,320639,50629,4867,14156,44586,114238
m,m,1750,40,7746,285,24,87,210,606
f,u,1746,0,0,0,0,0,0,0
u,f,1762,11,0,27,4,13,13,57
u,m,1784,300,4357,453,43,170,162,828
u,f,1787,93,65,184,22,63,47,316
m,f,1738,0,0,0,0,0,0,0
u,u,1730,0,0,0,0,0,0,0
f,u,1954,5859,626419,222817,16005,40509,117394,396725
m,u,1804,20,1057,677,43,229,689,1638
f,m,1714,0,0,0,0,0,0,0
m,m,1772,223,3659,868,133,320,575,1896
m,u,1930,17702,1464219,496602,36326,109231,264355,906514
f,f,1986,3330,320279,173833,11939,29072,92860,307704
u,u,1791,4,0,4,0,0,0,4
u,u,1747,0,0,0,0,0,0,0
m,u,1773,0,0,0,0,0,0,0
m,u,1865,888,102809,19507,1766,4971,11595,37839
m,f,1725,0,0,0,0,0,0,0
u,f,1915,2337,55586,9818,814,2738,2238,15608
m,m,1799,93,4635,1290,122,410,859,2681
f,f,1865,1841,521079,88989,8177,22022,65761,184949
f,f,1919,3101,691350,146226,11263,28728,88293,274510
u,f,1903,1442,38880,6530,483,1611,1455,10079
u,m,1712,0,0,0,0,0,0,0
u,u,1706,0,0,0,0,0,0,0
f,f,1847,640,177180,30256,2711,8781,26644,68392
u,u,1708,0,0,0,0,0,0,0
f,m,1724,0,0,0,0,0,0,0
u,m,1917,4148,110427,18424,1381,4842,3643,28290
u,f,1881,1448,47199,6069,526,1759,1433,9787
f,u,1891,368,48905,10707,1090,2849,8045,22691
u,m,1717,0,0,0,0,0,0,0
m,m,1980,19416,1527800,599357,37182,101102,264581,1002222
u,f,1760,0,0,0,0,0,0,0
m,f,1755,0,0,0,0,0,0,0
u,m,1847,751,39805,3015,249,1083,505,4852
m,m,1747,0,0,0,0,0,0,0
u,m,1798,71,684,146,16,42,77,281
m,u,1785,7,65,85,18,31,65,199
f,u,1825,158,16148,3466,397,970,3065,7898
f,u,1882,639,63890,12095,1169,3189,9166,25619
m,m,1766,27,0,67,13,36,42,158
u,u,1963,18165,387934,98819,6510,20621,19172,145122
m,f,1960,5605,536706,193041,13714,34511,81560,322826
u,u,1894,287,3443,758,71,230,125,1184
m,m,1781,68,4986,471,32,159,431,1093
m,m,1823,1954,227936,29721,2642,9313,23786,65462
u,f,1900,1690,45589,6703,578,1859,1563,10703
m,u,1949,17516,1200011,466496,33045,90722,225871,816134
m,u,1961,26590,2046244,757439,53351,146563,388211,1345564
f,u,1790,0,0,0,0,0,0,0
m,u,1717,0,0,0,0,0,0,0
m,f,1737,0,0,0,0,0,0,0
u,m,1852,2210,76981,6016,597,2140,1072,9825
m,u,1888,993,117135,17533,1481,4475,10888,34377
f,f,1763,0,0,0,0,0,0,0
u,u,1947,12111,242541,63045,4437,13683,12256,93421
m,f,1984,6160,425722,180661,12933,33470,84693,311757
m,f,1789,0,0,0,0,0,0,0
f,u,2003,9444,613803,293550,20970,55318,168902,538740
f,m,2008,5437,334286,216209,14333,38019,115047,383608
u,f,1806,178,7428,1315,88,474,411,2288
f,u,1923,4656,535406,158067,12718,35880,105332,311997
u,f,1748,0,0,0,0,0,0,0
f,u,1951,6963,708826,283077,21603,54217,157405,516302
m,f,1707,0,0,0,0,0,0,0
f,u,1780,28,1070,243,36,106,276,661
u,u,1863,182,3572,582,72,150,126,930
f,m,1812,128,13662,1790,140,686,1516,4132
u,f,1920,2329,52553,9618,798,2411,2460,15287
u,u,1861,222,4693,783,69,225,134,1211
f,m,1838,514,80664,11488,994,3763,10719,26964
f,f,1849,528,106843,17469,1422,4901,15605,39397
f,u,1735,0,0,0,0,0,0,0
u,u,1844,126,2271,432,39,178,88,737
m,u,1905,2813,346770,60663,4868,15025,33119,113675
m,f,1901,3435,400385,78797,6333,17460,42906,145496
f,m,2013,3,0,18,3,2,9,32
u,f,1982,3227,79915,26223,1730,4801,5992,38746
u,f,1948,2167,44746,12944,933,2716,2486,19079
m,f,1942,4514,416669,142202,11145,27142,66426,246915
f,m,1955,5804,652244,217390,15719,38973,108284,380366
f,u,1985,12236,931566,399168,29890,73394,220139,722591
u,m,1811,198,6751,494,48,204,117,863
f,u,1715,0,0,0,0,0,0,0
u,f,1737,0,0,0,0,0,0,0
m,u,1803,149,16096,2956,232,1113,2297,6598
f,m,2000,7512,603195,277033,18033,47792,145205,488063
m,m,1705,0,0,0,0,0,0,0
u,u,1782,0,0,0,0,0,0,0
m,f,1770,44,1335,440,36,203,298,977
m,u,2012,0,0,0,0,0,0,0
u,u,1813,4,25,4,0,2,4,10
f,m,1951,5829,571258,221554,16004,41313,111951,390822
m,u,1988,32960,1776483,754827,55651,141493,367068,1319039
f,m,1969,7740,554804,242156,17434,43902,125418,428910
f,f,1957,2714,336333,135025,10146,24440,67736,237347
f,m,1738,0,0,0,0,0,0,0
m,u,1992,40127,2025211,936444,67811,178594,464426,1647275
m,m,1720,0,0,0,0,0,0,0
m,m,1905,6523,902758,174773,12598,39243,93895,320509
u,f,1961,2767,59594,21224,1475,4303,4121,31123
u,u,1931,11678,228463,54028,3633,12574,11864,82099
m,m,1742,101,5594,1495,122,408,641,2666
f,u,1804,14,1744,890,43,270,927,2130
u,u,1937,8444,167813,39889,3231,8988,7766,59874
f,f,1956,2598,373248,141790,10724,24354,71238,248106
u,m,1858,1577,63413,6611,450,2109,755,9925
u,u,1750,0,0,0,0,0,0,0
u,m,1906,3657,103624,14971,1159,4109,3356,23595
f,m,1725,0,0,0,0,0,0,0
f,f,1931,2452,336864,126235,10027,24358,72599,233219
f,m,1709,0,0,0,0,0,0,0
f,m,1857,1583,251202,36927,3087,11346,31265,82625
u,u,1729,0,0,0,0,0,0,0
u,f,1899,2393,77143,10196,927,2794,2601,16518
u,u,1991,25507,436061,136192,9268,28089,29388,202937
m,f,1739,75,1540,670,74,248,537,1529
u,u,1884,145,2346,414,69,124,59,666
f,u,1969,13571,1128132,412795,33039,81944,236085,763863
m,f,1844,1302,194790,28761,2371,8589,20942,60663
m,f,1769,0,0,0,0,0,0,0
u,f,1922,2801,78940,14989,1264,3369,3331,22953
f,m,1726,15,0,13,13,4,18,48
f,m,1958,4930,463209,184324,13346,34786,90726,323182
u,m,1721,0,0,0,0,0,0,0
u,m,1980,10119,196531,55816,3431,10762,11838,81847
m,m,1819,825,102623,10791,871,3141,9404,24207
m,u,1735,0,0,0,0,0,0,0
u,f,1866,1143,41050,3428,417,1076,849,5770
u,u,1745,0,0,0,0,0,0,0
m,u,1714,0,0,0,0,0,0,0
u,m,1797,98,1763,139,9,86,37,271
f,m,1713,0,0,0,0,0,0,0
u,u,1779,31,506,103,10,39,17,169
u,f,1765,0,0,0,0,0,0,0
f,m,1943,3678,391696,134887,9738,24373,65206,234204
f,m,1737,0,0,0,0,0,0,0
u,m,1957,7905,148512,39527,2656,7685,7805,57673
u,f,1739,85,927,171,15,100,34,320
f,u,1816,129,15685,2150,254,781,2071,5256
m,f,1843,897,125070,18763,1446,5659,15325,41193
m,u,1941,11474,914416,318409,22178,63485,160130,564202
f,m,1963,5728,380974,185020,13415,35078,96624,330137
f,f,1893,3184,744134,135635,12378,30904,91881,270798
f,m,1707,0,0,0,0,0,0,0
f,m,1912,4062,735419,151286,11975,32711,86769,282741
m,u,1787,17,127,189,27,77,129,422
f,m,1856,1445,216224,32139,2870,9768,24670,69447
f,f,1754,0,0,0,0,0,0,0
u,f,1828,170,5477,545,37,199,115,896
m,m,1881,4454,732947,118953,10501,29863,68859,228176
f,f,1775,13,59,246,26,107,328,707
u,u,1755,0,0,0,0,0,0,0
f,u,1807,38,3832,924,123,349,1071,2467
u,f,1717,0,0,0,0,0,0,0
f,m,1743,0,0,0,0,0,0,0
m,f,2013,0,0,0,0,0,0,0
m,m,1958,15448,1479612,562713,37014,96761,238267,934755
m,m,1808,335,48266,6914,601,2292,7273,17080
m,u,1818,126,9905,1826,179,609,1880,4494
m,f,1822,617,102815,20596,1639,5962,15757,43954
u,f,1771,63,1395,134,12,41,31,218
u,m,1997,13438,210296,65919,4485,13359,15555,99318
u,m,1860,1554,58307,4945,351,1585,1056,7937
m,f,1757,0,0,0,0,0,0,0
m,f,1766,6,46,76,4,19,35,134
m,m,1811,448,43042,8508,634,2705,6910,18757
u,f,1709,0,0,0,0,0,0,0
m,f,1969,5012,401046,161807,11457,29141,72868,275273
u,f,1740,0,0,0,0,0,0,0
u,u,1966,20326,412325,109782,7302,23058,23312,163454
u,m,1970,11498,182855,61089,3909,11283,12472,88753
u,u,1950,15785,405381,89004,5777,18654,17148,130583
f,f,1756,0,0,0,0,0,0,0
f,f,1742,0,0,0,0,0,0,0
u,u,1752,13,0,27,3,7,2,39
u,f,1983,2731,48795,16449,1067,3137,3626,24279
u,u,1895,665,15947,2522,213,774,600,4109
m,m,1970,23085,1570145,680310,44437,114845,300974,1140566
m,f,1940,3398,316526,112694,7740,20855,49872,191161
f,u,1734,0,0,0,0,0,0,0
m,f,1830,787,116640,15616,1340,4395,12652,34003
u,f,1993,5021,111403,35841,2434,6090,8663,53028
u,m,1742,44,579,57,3,19,10,89
u,m,1728,62,0,138,14,36,22,210
m,u,1903,3189,350776,68971,5226,16432,36843,127472
f,u,1713,0,0,0,0,0,0,0
m,m,1725,0,0,0,0,0,0,0
f,f,1859,945,171804,28967,2552,7549,25157,64225
f,u,1831,105,13257,1972,253,575,1932,4732
m,f,1994,11927,820598,385409,25288,68226,178701,657624
u,u,1723,0,0,0,0,0,0,0
m,u,1796,9,92,24,2,10,25,61
f,f,1728,0,0,0,0,0,0,0
f,u,1959,6990,559735,202068,15569,40621,117640,375898
f,m,1769,5,0,0,0,0,1,1
m,m,1955,18585,1713759,653305,43379,110931,284956,1092571
f,u,1840,87,7872,856,80,323,1064,2323
m,m,1901,7150,927565,174297,12904,41689,99435,328325
u,u,1970,25512,462674,125002,8900,27566,25109,186577
m,f,1874,2346,354573,62444,5594,15812,34457,118307
f,m,1968,7312,594685,252274,18833,47229,131021,449357
f,u,1837,84,20450,1620,88,509,1227,3444
m,f,1975,5450,325105,143447,10972,27912,64298,246629
u,f,1883,1726,50073,6636,665,1978,1706,10985
m,u,1997,32841,1609257,740989,53114,143687,362251,1300041
f,u,1717,0,0,0,0,0,0,0
m,m,1884,5807,657133,130282,11283,33654,77252,252471
u,u,2010,1075,10242,4843,347,1026,836,7052
m,m,2002,19724,1256074,592079,36716,98348,269872,997015
m,m,2000,24430,1554190,733882,47502,124952,337607,1243943
u,f,1875,1479,31806,5672,550,1576,1596,9394
m,u,1779,10,848,259,11,80,313,663
u,f,1896,3727,147106,17760,1367,4977,3845,27949
f,u,1798,0,0,0,0,0,0,0
f,u,1760,16,159,252,34,112,352,750
m,f,1713,0,0,0,0,0,0,0
u,m,1882,3029,73812,9673,913,2908,2536,16030
m,f,1913,5851,806054,168651,12939,36397,87727,305714
u,u,1907,1607,36854,6336,465,1485,1238,9524
u,m,1951,8565,195478,48279,3260,9662,8636,69837
u,f,2011,0,0,0,0,0,0,0
m,u,1948,21642,1521487,582371,43141,114763,282488,1022763
m,f,1720,0,0,0,0,0,0,0
f,u,1964,8037,703707,280471,20773,53661,153964,508869
u,m,1911,4559,119244,18015,1371,4744,4060,28190
u,f,1730,0,0,0,0,0,0,0
m,f,1872,2825,384462,65152,6173,16549,39745,127619
f,f,1994,6518,702573,379339,23269,59055,200586,662249
u,u,2002,20421,316713,98703,6815,18989,22696,147203
m,m,1854,3798,433460,60254,5072,17564,43863,126753
m,f,1894,4786,659339,118034,10636,29056,68917,226643
m,f,1963,4401,370268,157855,11100,28532,69435,266922
f,m,1852,1468,284967,35824,3245,11138,29212,79419
f,u,1900,9375,1367760,320934,26707,78093,222222,647956
f,f,1939,1827,240938,89785,6409,15825,47005,159024
m,f,1772,36,1124,206,16,64,162,448
u,f,1722,124,624,302,27,143,51,523
m,m,1885,6181,672624,115978,10106,29869,70629,226582
m,f,1827,1287,196748,29328,2073,8944,21390,61735
m,m,1754,28,79,60,8,19,37,124
u,m,1829,1910,89260,5197,451,1743,1208,8599
m,f,1716,0,0,0,0,0,0,0
m,m,1733,28,0,80,7,33,38,158
m,m,1775,0,0,0,0,0,0,0
u,f,1779,8,36,11,2,4,1,18
m,f,1743,67,0,809,73,351,576,1809
u,m,1927,7317,174517,32499,2406,8239,7370,50514
m,f,1790,0,0,0,0,0,0,0
f,u,1960,8727,745445,311540,22929,60104,167970,562543
m,u,1845,414,64725,6385,451,2039,5113,13988
f,f,1799,143,13547,2000,221,875,2861,5957
u,u,1793,17,132,10,1,9,1,21
m,m,1998,20513,1389340,623174,39109,104668,296267,1063218
f,m,1788,129,7003,871,75,367,918,2231
u,f,2013,0,0,0,0,0,0,0
u,m,1999,10593,204110,57226,3660,10801,12817,84504
m,f,1793,68,14020,1985,137,664,1799,4585
u,m,1842,1106,53879,4286,320,1538,796,6940
u,m,1785,211,3097,480,49,262,147,938
u,m,1714,0,0,0,0,0,0,0
f,f,1750,0,0,0,0,0,0,0
f,u,1908,1423,194385,39479,2913,9084,25709,77185
u,u,1976,20593,319350,91591,6767,19825,19350,137533
u,f,1834,438,16563,1383,111,470,322,2286
f,f,1765,0,0,0,0,0,0,0
u,m,1861,851,25254,2520,224,701,466,3911
f,u,1945,5470,531941,184269,13622,32726,95866,326483
u,u,1962,19750,409978,108099,6983,24459,20596,160137
m,u,1970,39137,2199572,847598,65090,175978,441640,1530306
m,f,1891,4150,595891,107597,9999,25940,62553,206089
f,f,1909,2624,572373,103601,8010,22313,63615,197539
u,f,1715,0,0,0,0,0,0,0
m,u,1924,11229,725566,251936,19840,53558,135297,460631
f,m,1763,54,3685,501,56,245,499,1301
u,m,1719,4,0,0,0,2,0,2
m,m,1986,17499,1086764,518142,32927,87156,232121,870346
u,m,1752,82,348,170,10,74,30,284
m,m,1817,277,25433,4816,356,1362,3128,9662
m,u,1897,709,78912,12420,1020,2950,7393,23783
u,f,1801,104,1310,259,24,79,71,433
f,f,1725,0,0,0,0,0,0,0
u,u,1873,221,1259,243,41,98,62,444
f,u,1916,1584,259261,52122,3876,12122,29919,98039
m,m,1749,137,9331,2368,191,792,1565,4916
m,f,1828,454,101560,12816,1062,4138,9634,27650
u,u,1899,729,26896,3329,233,715,607,4884
f,f,1747,0,0,0,0,0,0,0
m,f,1746,0,0,0,0,0,0,0
u,u,1913,2482,64587,11271,893,2984,2066,17214
u,f,1733,0,0,0,0,0,0,0
u,f,1852,562,29124,3178,241,675,896,4990
u,f,1799,111,1599,214,24,79,70,387
u,u,1924,7955,140724,32625,2372,8275,6481,49753
u,f,2009,2942,34810,20395,1235,3837,4592,30059
u,m,1969,12853,200647,56333,3970,11507,10627,82437
f,f,2000,6128,719397,370223,24606,59394,197452,651675
f,f,1823,291,74471,13114,1180,4501,11177,29972
f,f,1947,3048,408117,153750,11443,25567,77156,267916
u,u,1939,7563,191423,37385,2689,8262,7935,56271
f,m,1913,4104,736841,151688,11611,33465,91792,288556
f,u,1824,79,12647,3542,324,1293,3192,8351
u,u,1769,10,127,28,5,10,5,48
u,u,2001,18737,315167,104217,7124,21253,23721,156315
m,m,1763,163,2625,1163,102,423,977,2665
u,u,1778,0,0,0,0,0,0,0
u,m,1800,69,780,116,12,63,14,205
m,f,1773,0,0,0,0,0,0,0
f,u,1797,0,0,0,0,0,0,0
m,u,1730,0,0,0,0,0,0,0
m,f,1792,77,6179,2104,165,608,1948,4825
u,f,1741,0,0,0,0,0,0,0
f,m,1956,5163,554080,203687,13855,36054,103835,357431
u,f,1968,2656,49599,15211,983,3055,3239,22488
f,u,1770,0,0,0,0,0,0,0
m,u,1836,187,14629,2502,262,783,2475,6022
f,f,1921,2708,681545,155437,11724,30969,91183,289313
f,f,1812,356,82106,14215,1281,5020,12626,33142
f,f,1733,0,0,0,0,0,0,0
u,m,2002,10305,155892,54625,3555,9884,10965,79029
m,f,1715,0,0,0,0,0,0,0
u,u,1763,0,0,0,0,0,0,0
f,f,1829,577,126956,19111,1645,5767,18105,44628
f,f,1988,5000,514272,254847,15951,40045,133803,444646
f,f,1743,30,674,751,63,407,574,1795
m,f,1931,4592,458090,167269,13297,33511,80838,294915
u,f,1846,409,12512,1335,127,471,309,2242
m,f,1816,488,94371,15326,1073,4905,10563,31867
f,u,1721,0,0,0,0,0,0,0
m,u,1904,2768,250990,56314,4677,13482,29202,103675
f,f,1711,0,0,0,0,0,0,0
m,f,1808,96,11323,1301,130,486,1420,3337
m,m,1731,0,0,0,0,0,0,0
m,f,1846,907,121250,20590,1844,5540,15091,43065
m,u,1896,991,116864,20018,1626,4843,10314,36801
m,m,1722,52,1164,235,26,103,114,478
u,u,1881,268,4332,572,74,184,95,925
m,m,1796,481,42452,7528,601,2652,7650,18431
u,m,1943,6400,118696,29389,2081,6462,4953,42885
u,m,1803,147,2368,286,26,109,62,483
u,m,1838,640,23024,1953,160,655,365,3133
m,u,1799,0,0,0,0,0,0,0
u,m,1885,3638,102617,11781,921,3354,2468,18524
f,m,1891,2390,412692,75958,6674,18160,50434,151226
f,f,1720,0,0,0,0,0,0,0
m,m,1909,9299,1336848,250290,18040,56446,132322,457098
u,m,1713,0,0,0,0,0,0,0
f,f,1943,2302,313418,117344,8175,19372,56335,201226
u,u,1973,17604,292284,86409,6192,18266,18157,129024
f,f,1811,120,37586,7987,563,2586,7257,18393
m,u,2010,1548,66646,31898,2446,6576,15802,56722
m,m,1757,0,0,0,0,0,0,0
f,u,1795,21,896,238,31,127,337,733
m,m,1956,17609,1528932,569492,37104,94892,250485,951973
u,m,1856,1498,55702,4576,413,1469,963,7421
m,u,1991,38483,1732117,835834,60981,159361,412501,1468677
u,m,1840,1856,38220,3935,341,1557,703,6536
m,m,1783,12,196,35,0,19,48,102
m,f,1957,4974,417102,169322,12780,30834,70606,283542
u,u,1846,227,12569,707,56,266,94,1123
u,u,1843,199,11347,1072,86,404,230,1792
u,f,1720,0,0,0,0,0,0,0
m,m,1907,9184,1199789,239174,17581,54035,125093,435883
m,m,1961,19404,1687861,631297,42013,106724,273600,1053634
u,u,1979,19820,396061,105909,7069,21740,21793,156511
f,u,1740,0,0,0,0,0,0,0
f,m,1746,0,0,0,0,0,0,0
u,f,1734,0,0,0,0,0,0,0
m,m,1769,52,1127,160,9,63,69,301
m,f,1958,4899,421016,147603,11214,26925,64590,250332
u,f,1912,2407,61188,9791,775,2550,2202,15318
f,u,1759,0,0,0,0,0,0,0
f,u,1820,47,12482,1651,146,530,1023,3350
u,f,1703,0,0,0,0,0,0,0
f,m,1906,2829,427425,92192,6928,20722,57799,177641
m,u,1738,0,0,0,0,0,0,0
u,m,1964,10328,184931,54502,3774,10858,10560,79694
f,m,1836,772,128576,14018,1207,4353,13258,32836
f,f,1855,1218,336820,52524,4356,13737,44883,115500
m,u,1980,29520,1578756,707803,49843,129143,340939,1227728
f,f,1868,1475,346489,64591,5484,15801,48307,134183
m,m,1801,541,48842,7714,675,2731,6195,17315
m,u,1916,4532,433338,95103,6950,22659,46217,170929
m,m,1913,12083,1816371,350570,24589,76901,175201,627261
u,m,1820,348,13187,1416,109,377,277,2179
f,f,1824,433,133540,20672,1738,6460,17848,46718
f,m,1884,1988,273497,63268,6036,16248,43104,128656
u,f,1917,2051,54009,9241,743,2260,2182,14426
m,m,1836,2343,282681,31170,2516,9321,25098,68105
f,u,1761,0,0,0,0,0,0,0
m,m,1893,10525,1574080,268249,20850,68065,149520,506684
u,f,1798,105,1520,332,49,143,84,608
m,f,1912,4990,661319,135511,10529,29406,72088,247534
m,f,1856,2320,369247,55342,5214,14542,38023,113121
f,m,1892,3114,488319,98856,8417,24380,66578,198231
m,m,1921,11785,1615948,385211,27607,80797,199238,692853
u,u,1981,21203,367997,105480,7143,21332,24200,158155
f,f,1881,1930,415567,80861,7125,18950,56549,163485
m,m,1753,16,19,64,4,48,61,177
u,m,1949,7339,132074,33092,2213,6698,6844,48847
f,m,1715,3,0,4,2,3,3,12
u,m,1824,688,15277,1307,112,549,304,2272
m,u,1890,828,71022,14147,1272,3548,8316,27283
m,m,1716,0,0,0,0,0,0,0
u,u,1985,21780,369750,117414,8019,24244,26386,176063
u,u,1797,0,0,0,0,0,0,0
u,f,1763,0,0,0,0,0,0,0
f,u,1941,4339,507280,164285,11938,28810,89825,294858
m,u,1729,0,0,0,0,0,0,0
m,m,1743,0,0,0,0,0,0,0
m,u,1736,0,0,0,0,0,0,0
m,f,2007,12366,754506,413520,28625,74446,193688,710279
u,m,1880,2713,86467,8958,750,2635,2324,14667
f,u,1788,15,185,114,16,55,163,348
f,u,1934,4068,328053,135785,11431,27513,77252,251981
f,u,1845,165,22973,2561,214,739,2106,5620
f,m,1757,0,0,0,0,0,0,0
f,u,1841,63,6884,1557,116,443,1310,3426
f,f,1796,48,1970,668,63,255,629,1615
f,m,1934,4257,449273,169057,14161,34310,95219,312747
f,f,1805,69,11527,3375,210,1354,3296,8235
m,m,1708,91,302,1342,125,496,776,2739
f,u,1719,0,0,0,0,0,0,0
f,u,1709,0,0,0,0,0,0,0
u,u,1822,258,4958,512,37,233,217,999
u,f,1822,228,5700,833,77,301,272,1483
u,m,1764,145,2653,508,58,188,62,816
f,u,1999,12985,778035,388545,27694,70812,224791,711842
f,f,1917,2888,685530,137745,10695,27791,81413,257644
m,m,1943,13048,1185765,410275,28040,68223,174167,680705
f,m,1863,717,110691,18946,1873,5432,14877,41128
m,u,1783,0,0,0,0,0,0,0
u,f,1847,563,13221,1300,109,448,287,2144
m,m,1872,7274,1085928,140704,11567,38796,84872,275939
f,m,1830,633,108653,13445,1129,4642,14155,33371
u,u,1886,386,12119,1115,130,372,283,1900
f,f,1816,266,97949,12396,956,4299,10485,28136
m,m,1859,5064,696897,89002,7645,24611,64133,185391
u,f,1945,2171,65985,16108,1088,3166,3240,23602
m,f,1777,0,0,0,0,0,0,0
m,f,1712,0,0,0,0,0,0,0
f,u,2000,12701,857516,371359,26176,70018,213419,680972
m,u,1705,0,0,0,0,0,0,0
m,u,1932,12931,906505,313248,23134,63967,165004,565353
f,f,2013,0,0,0,0,0,0,0
f,u,1853,305,52368,8364,705,2427,6792,18288
m,m,1728,35,7385,414,42,120,208,784
f,f,1961,2262,274321,112109,7728,18551,55859,194247
m,m,1918,9257,1215586,263901,19332,55739,129984,468956
m,m,1939,9523,834352,297858,20449,54296,140853,513456
u,u,1718,0,0,0,0,0,0,0
m,m,1892,9629,1177593,214920,18370,52947,125588,411825
f,f,1769,0,0,0,0,0,0,0
f,m,1896,4209,584355,108342,9478,26724,71832,216376
f,m,1731,0,0,0,0,0,0,0
f,m,1975,4989,390647,171453,11424,31145,88210,302232
f,u,1801,11,583,170,24,55,186,435
m,u,2005,31180,1513615,725892,51390,139004,354628,1270914
u,m,1961,10410,181530,53324,3405,10242,10427,77398
f,f,1828,282,66833,10507,862,3448,9627,24444
u,m,1778,0,0,0,0,0,0,0
u,u,1783,0,0,0,0,0,0,0
m,f,1906,3966,554397,111608,8539,24532,60899,205578
m,f,1764,0,0,0,0,0,0,0
u,u,1929,14951,278456,63553,4518,15851,12939,96861
m,m,1868,3216,482537,84331,7035,22723,49164,163253
f,u,1892,359,45863,10387,933,2626,8544,22490
f,m,1704,0,0,0,0,0,0,0
u,u,1992,26336,511855,145387,10499,30266,32656,218808
f,f,1913,3674,781181,156108,11485,31931,97843,297367
f,m,1780,18,679,49,2,19,45,115
f,m,1720,0,0,0,0,0,0,0
u,f,1769,0,0,0,0,0,0,0
f,u,1839,251,47325,5893,501,1869,5334,13597
u,m,1899,10617,363241,44880,3707,12258,11182,72027
f,m,1875,916,207965,38789,3434,10154,27231,79608
m,u,1850,51,5744,563,45,147,438,1193
f,m,1710,0,0,0,0,0,0,0
f,f,1773,0,0,0,0,0,0,0
u,m,1948,6516,159864,34644,2318,6926,7224,51112
m,u,1867,637,76002,13992,1063,3739,9293,28087
f,u,1774,1,0,1,0,0,0,1
m,m,1928,13667,1222209,403470,29299,81626,207802,722197
f,u,1992,15464,975792,497672,36275,90795,279581,904323
m,f,1892,4496,594744,114025,10577,27109,66766,218477
f,m,1827,460,56630,7985,836,2897,8129,19847
u,m,1826,950,33405,2382,159,777,726,4044
f,f,1808,66,11674,1608,141,577,1717,4043
f,f,1768,0,0,0,0,0,0,0
m,u,1935,13540,1142456,381437,29031,73119,194501,678088
u,u,1761,0,0,0,0,0,0,0
u,f,1891,1992,58639,7139,629,2069,1795,11632
u,m,1866,2309,81804,7597,710,2393,1477,12177
u,u,1816,76,2033,132,19,52,36,239
u,u,1967,25734,401736,116912,8291,27821,24116,177140
f,u,1803,80,10322,1313,122,495,1389,3319
f,f,1998,6134,610120,322774,21475,52788,179769,576806
m,u,1820,141,18077,2703,229,756,2037,5725
m,u,1974,23786,1258491,560005,41020,109233,266003,976261
u,f,1723,0,0,0,0,0,0,0
u,f,1814,364,3913,1305,93,483,315,2196
m,u,1716,0,0,0,0,0,0,0
f,m,1995,6472,610516,261131,16520,44401,138844,460896
f,m,1850,1481,410464,53699,4105,16421,45710,119935
m,m,1917,8546,1153191,257328,17870,53563,130556,459317
f,f,1932,1980,284074,124251,9132,22247,69383,225013
u,u,1878,284,9990,914,91,235,229,1469
u,u,1927,9478,140638,34821,2808,9513,6800,53942
m,f,1763,0,0,0,0,0,0,0
u,m,1754,40,0,69,9,21,23,122
u,f,1930,1925,40675,13227,1064,2983,3027,20301
m,u,1827,352,41543,5948,587,1666,4246,12447
m,f,1893,5284,698183,137760,12396,33270,78488,261914
u,u,1999,20455,346713,112198,7605,22863,27108,169774
f,f,1832,726,141228,20393,1995,6142,17502,46032
u,m,1759,87,887,155,15,77,8,255
m,f,1719,38,4814,469,49,237,352,1107
u,m,1965,11208,201469,59051,3722,11632,11186,85591
u,u,1855,349,5859,884,93,299,253,1529
f,u,1987,11054,731019,336702,25982,62457,182131,607272
f,u,1863,326,69882,11286,1057,2767,8797,23907
m,m,1903,7073,879382,170245,13021,40830,93318,317414
u,m,1821,357,16643,1206,78,374,240,1898
f,u,1814,16,10178,1501,113,407,1326,3347
u,u,1974,15277,275256,75313,5367,15947,15033,111660
u,m,1739,188,3037,487,35,238,55,815
u,f,1859,493,10234,1688,110,438,346,2582
u,f,1895,2282,62432,7873,740,2313,1823,12749
f,m,1764,26,943,90,6,69,90,255
m,u,1841,203,21885,4491,324,1408,2899,9122
m,m,1927,14318,1419058,450549,33416,93432,236693,814090
f,f,1981,3528,441728,207193,13766,34195,108499,363653
m,f,1704,0,0,0,0,0,0,0
f,u,1925,4311,478131,161941,12226,35578,103743,313488
m,u,1939,11110,951161,303664,20622,56934,148534,529754
f,u,1912,2034,233730,50885,3950,11997,33577,100409
m,f,1809,453,78383,12775,1083,4156,9333,27347
m,f,1875,3215,424526,91864,7955,22988,55178,177985
m,f,1710,0,0,0,0,0,0,0
m,m,1774,99,12045,1690,150,504,1385,3729
m,m,1773,19,1748,727,38,199,596,1560
f,m,1792,46,1247,422,51,162,465,1100
m,f,1956,4942,468734,173937,12940,31471,75637,293985
m,m,1800,148,29705,4550,341,1418,3135,9444
m,u,1998,31218,1410685,688747,50440,133453,346906,1219546
f,f,1928,2405,334950,119602,8906,21609,67794,217911
m,f,1980,6510,416207,198747,14290,36562,94641,344240
u,m,1883,4952,114331,11883,1078,3706,2821,19488
f,m,1908,2885,485129,107154,8245,24331,65707,205437
m,m,1736,180,10500,2699,219,1187,2286,6391
u,f,1790,0,0,0,0,0,0,0
f,m,1941,3302,317245,125342,9285,23587,67388,225602
f,u,1869,184,40586,6645,597,1701,6037,14980
u,m,1939,5021,112271,24704,1767,5401,5305,37177
m,u,1789,44,531,415,58,157,421,1051
f,m,1793,26,6544,1156,99,476,870,2601
m,m,1810,575,39430,11788,1074,3799,9320,25981
u,m,1740,109,3676,188,7,101,33,329
f,u,1921,1565,278064,55834,4354,12865,28988,102041
u,f,1951,2723,54965,15241,1119,3134,2891,22385
f,m,1864,1269,237785,40020,3706,11663,30157,85546
m,m,1920,12570,1580986,374155,27038,80164,186921,668278
f,f,1927,2219,301033,113950,8972,22067,67711,212700
f,f,1906,2279,482089,94125,7533,19469,59819,180946
m,m,1968,23618,1766882,736801,49789,126852,320823,1234265
m,f,1779,19,1120,338,50,116,216,720
f,f,1895,2440,529529,102870,8630,22403,67725,201628
f,f,1722,20,2080,217,19,143,201,580
m,m,1886,5332,672683,120016,10063,29845,70719,230643
m,f,1774,44,2201,420,45,153,173,791
m,m,1906,7993,1161439,216244,15533,47866,115031,394674
m,f,1722,46,4680,621,54,273,414,1362
u,f,1736,0,0,0,0,0,0,0
f,u,1733,0,0,0,0,0,0,0
u,m,1816,142,6743,394,50,157,88,689
f,m,1868,1133,153679,27827,2607,8313,21256,60003
u,f,1829,337,11888,941,99,339,286,1665
u,m,2013,16,0,181,23,63,41,308
m,u,1855,926,100761,17273,1605,4938,12019,35835
u,f,1991,4974,87993,30108,2286,5934,6990,45318
m,u,1923,14061,1068767,335818,24717,75909,188310,624754
f,u,1764,0,0,0,0,0,0,0
m,u,1776,0,0,0,0,0,0,0
f,f,1783,0,0,0,0,0,0,0
f,m,1748,2,0,0,0,3,0,3
m,u,1790,0,0,0,0,0,0,0
m,u,1834,520,61846,7746,596,2217,6286,16845
u,m,2012,0,0,0,0,0,0,0
u,u,1772,0,0,0,0,0,0,0
u,f,1937,2505,68277,16948,1295,3449,3621,25313
f,m,1805,30,590,296,42,119,289,746
m,m,1966,20012,1471611,640278,41843,107346,279097,1068564
u,u,1851,205,7022,498,33,163,120,814
f,f,1896,3078,629987,108355,9786,24365,74254,216760
f,u,1777,0,0,0,0,0,0,0
m,u,1762,0,0,0,0,0,0,0
f,m,1806,112,9816,1784,158,581,2129,4652
f,u,1899,398,67223,10973,859,2575,7863,22270
m,u,1824,191,16067,3729,320,1087,2437,7573
m,m,1855,3075,421225,59643,4468,16431,38570,119112
m,m,1950,16373,1818370,609131,39135,102085,276356,1026707
u,u,1874,146,1959,236,37,86,92,451
u,u,1853,226,7686,805,56,268,122,1251
m,u,1801,27,5024,798,80,274,565,1717
f,u,1852,213,47172,6725,540,2016,5029,14310
m,m,1824,1482,131257,22825,1820,7199,18506,50350
m,m,1931,10608,981330,339656,23264,64917,163521,591358
f,f,1813,410,69483,11315,803,4020,14119,30257
f,f,1836,709,162753,23577,2083,7330,22424,55414
m,u,1891,820,84972,17042,1544,4470,10587,33643
u,u,1833,84,5202,247,24,122,91,484
f,m,1937,4842,495002,193855,14708,35383,97819,341765
f,u,1731,0,0,0,0,0,0,0
f,f,1851,771,211170,33000,3026,9485,30162,75673
f,f,1800,184,32416,6557,678,2156,6144,15535
f,m,1952,5623,623833,225995,16488,41481,113952,397916
m,f,1934,5118,415749,161082,12816,32356,79450,285704
u,u,1960,16870,385607,96344,5996,19928,19380,141648
f,f,1736,0,0,0,0,0,0,0
f,f,1842,563,129621,21311,1927,6192,18681,48111
f,u,1794,47,8200,1863,198,681,1965,4707
f,m,1760,10,29,55,9,48,93,205
f,u,1893,388,58402,12138,1123,2657,9130,25048
u,f,1714,0,0,0,0,0,0,0
u,f,1839,496,14660,1716,127,621,452,2916
m,u,1746,0,0,0,0,0,0,0
u,f,1976,2796,65655,20218,1320,3792,4320,29650
u,f,1914,2364,76241,11045,801,2688,2433,16967
f,f,1810,338,58023,13213,1021,4859,13872,32965
f,m,1787,23,1114,172,16,97,229,514
u,f,1861,579,13670,1709,192,589,425,2915
f,m,2006,6625,404638,237481,15908,40417,127030,420836
f,m,2007,6719,471889,262203,17793,45450,137933,463379
u,m,1827,557,19579,1799,247,588,433,3067
m,f,1864,2550,386988,60096,5258,16046,36508,117908
m,m,1703,141,13104,1423,113,672,1215,3423
u,m,1988,10880,180844,56926,3518,10644,12674,83762
u,m,1715,22,0,17,4,10,3,34
u,f,1800,93,2184,266,32,108,52,458
f,u,1844,135,22813,4484,294,1334,4267,10379
u,u,1722,20,0,21,3,16,0,40
f,m,1855,1004,177987,25866,2231,7983,18902,54982
u,u,1948,12746,262707,62478,4471,14219,11830,92998
u,f,1752,0,0,0,0,0,0,0
u,m,1704,0,0,0,0,0,0,0
m,f,1880,3155,359021,80315,7041,20621,49895,157872
u,u,1942,7664,124701,34970,2571,7591,7150,52282
m,f,1868,2454,348353,68275,5967,17250,40473,131965
u,u,1877,185,5776,387,62,125,82,656
u,f,1743,119,2743,363,33,195,27,618
u,f,1931,2389,49673,13181,1022,3247,3262,20712
u,u,2013,0,0,0,0,0,0,0
f,f,1704,0,0,0,0,0,0,0
u,u,1705,0,0,0,0,0,0,0
u,m,1747,0,0,0,0,0,0,0
f,f,2010,3,0,124,2,17,66,209
f,m,1777,15,0,209,35,79,208,531
u,m,1709,0,0,0,0,0,0,0
u,f,1901,1754,48703,7378,532,1888,1667,11465
m,m,1959,17287,1591526,572416,36766,96214,256360,961756
m,f,1736,0,0,0,0,0,0,0
u,u,1908,3138,36263,7160,642,1790,2119,11711
f,f,1918,2573,546326,120301,9190,24641,70843,224975
m,u,1795,44,2979,412,53,203,403,1071
f,f,1966,2472,242602,106957,7801,18082,50435,183275
f,m,1721,0,0,0,0,0,0,0
m,f,1896,6334,802706,134387,11859,32733,79552,258531
f,m,1765,0,0,0,0,0,0,0
u,u,1837,116,7633,572,55,194,75,896
f,u,1907,871,108650,22804,1953,5625,13870,44252
u,f,1713,0,0,0,0,0,0,0
u,m,1830,1100,39439,3013,284,1217,651,5165
f,u,1914,1326,186974,33670,2612,8564,21119,65965
m,f,1806,276,24580,6954,510,2253,6026,15743
u,m,1741,16,0,15,1,8,7,31
m,m,1940,11993,1229146,425282,28285,74401,190326,718294
u,f,1840,518,18335,1699,156,533,411,2799
m,m,1829,4431,678530,65299,5210,18691,55299,144499
m,f,1780,0,0,0,0,0,0,0
f,f,1741,0,0,0,0,0,0,0
u,m,1855,1253,37160,3947,280,1189,828,6244
f,u,1894,323,45921,12177,897,2433,8389,23896
m,m,1848,3049,448239,57364,4442,16217,41512,119535
m,f,1937,5192,491514,167317,12605,31625,78627,290174
f,u,1729,0,0,0,0,0,0,0
u,u,1987,20373,325575,106844,7394,22062,23559,159859
u,u,1785,8,13,40,9,9,9,67
u,u,1940,7635,173100,46480,3161,10302,8731,68674
f,f,1904,1683,347695,61757,4554,13000,39607,118918
f,u,1802,53,7833,1100,81,394,1224,2799
m,f,1760,0,0,0,0,0,0,0
u,u,1914,1974,52262,7549,569,1948,1597,11663
u,m,1904,3571,80878,13390,1027,3854,2477,20748
u,m,1973,9707,166766,46292,3111,9132,9799,68334
f,u,1711,0,0,0,0,0,0,0
u,u,2004,20225,319394,106672,7818,22743,25236,162469
m,u,1812,93,11828,1978,191,643,1794,4606
m,f,1974,4491,263616,131122,10107,25442,62969,229640
m,u,1823,81,7314,1336,153,396,1146,3031
m,f,1966,4728,400888,158030,11197,27760,67707,264694
f,f,1703,0,0,0,0,0,0,0
f,f,1973,2629,230623,130116,9522,23322,65538,228498
f,u,1878,218,29420,6314,540,1560,4838,13252
m,f,1927,3573,330778,118558,10001,25045,60654,214258
u,f,1856,893,21216,2793,267,823,795,4678
f,m,1723,0,0,0,0,0,0,0
u,u,1735,0,0,0,0,0,0,0
m,f,1995,10818,708733,338172,23414,61036,154470,577092
f,u,2004,11108,630537,328824,24011,60659,189382,602876
m,f,1850,1291,213168,30835,2540,8326,21782,63483
m,m,1932,12197,1147627,411265,30343,80004,194592,716204
m,f,1921,4178,571727,143721,11159,30778,69994,255652
m,m,1704,0,0,0,0,0,0,0
u,f,1786,27,240,32,1,6,1,40
m,f,1745,0,0,0,0,0,0,0
u,u,1858,793,19996,2063,178,637,606,3484
u,u,1906,1119,29404,4415,358,1211,956,6940
m,m,1813,125,6530,974,73,399,500,1946
u,f,1908,2068,64229,8952,662,2076,1952,13642
m,u,1802,57,8322,1282,102,438,1100,2922
u,f,1864,1216,42283,4178,378,1328,1021,6905
f,u,1994,15349,1023098,494799,36248,90568,277203,898818
m,u,1831,303,26813,4925,469,1536,4102,11032
f,f,1924,1701,259408,85286,6643,16477,53230,161636
m,u,1747,0,0,0,0,0,0,0
f,m,1719,5,0,12,3,18,31,64
u,u,1932,9625,227836,47894,2947,10859,10234,71934
f,m,1736,142,3937,1149,104,774,1734,3761
m,f,1753,35,803,617,63,247,379,1306
f,u,1757,0,0,0,0,0,0,0
m,u,1819,169,29894,4306,330,1552,3170,9358
m,m,1977,17184,1180682,524381,33209,86391,239480,883461
m,u,1750,0,0,0,0,0,0,0
m,f,1765,0,0,0,0,0,0,0
f,f,1903,1834,370068,73933,5678,15691,48457,143759
f,f,1864,1373,359293,59991,5124,15025,45214,125354
m,m,1706,0,0,0,0,0,0,0
f,u,1727,0,0,0,0,0,0,0
u,m,1929,7924,116824,31329,2368,8024,6375,48096
f,m,1895,3762,603439,113903,9757,27222,72465,223347
m,m,1804,470,32269,6224,575,2166,5061,14026
m,m,1947,19947,1616100,581874,40959,100405,271731,994969
f,f,1940,1626,272247,100540,6831,16605,48094,172070
f,f,1938,2914,470072,186309,12850,31754,109832,340745
u,f,2001,5513,113130,31767,2181,6522,7918,48388
m,u,1813,25,3094,836,101,250,588,1775
f,u,1911,1235,162402,29976,2567,7220,18412,58175
f,f,1848,661,213938,28413,2684,7888,25067,64052
m,u,1782,0,0,0,0,0,0,0
f,u,1953,7058,567923,208648,15063,38942,110764,373417
f,u,1967,11725,1020241,408390,30878,80514,234214,753996
u,u,1823,30,355,123,8,28,17,176
u,u,1808,36,347,76,11,23,20,130
u,f,1880,2486,95522,13048,941,3901,3276,21166
u,m,1919,5124,126445,22713,1780,5405,4862,34760
f,u,1793,17,513,583,29,193,760,1565
u,u,1885,311,9185,1047,121,295,301,1764
u,m,1848,1452,43649,3934,325,1449,865,6573
m,f,1908,4476,601838,118287,9213,25998,60573,214071
u,f,1926,1675,30465,7687,629,1946,1769,12031
f,f,1948,2540,406283,145368,10721,25045,75599,256733
m,u,1843,376,72475,7955,556,2319,5778,16608
f,u,1873,292,56155,9973,985,2620,7037,20615
f,m,1842,647,153841,24477,1813,7378,19776,53444
u,f,1808,82,3157,348,21,143,34,546
m,u,1985,32607,1617823,724014,52695,135110,349251,1261070
f,f,1871,1422,360684,58635,5341,14145,43035,121156
m,f,1886,4440,598269,110821,10101,26503,66472,213897
f,m,1931,3475,349055,127516,9564,25386,70485,232951
u,m,1822,248,7991,512,45,170,114,841
f,m,1974,5524,343435,160926,11557,29861,83082,285426
f,f,1787,60,6318,899,84,499,1244,2726
f,m,1966,6439,524866,214002,15278,38858,112082,380220
f,f,1920,3300,707050,165672,12478,32597,95393,306140
f,m,1779,0,0,0,0,0,0,0
m,u,1732,3,0,5,1,3,0,9
m,m,1895,12222,1570165,280813,21651,69388,160256,532108
f,m,1927,4769,569126,187366,14090,39464,112487,353407
f,f,1971,1881,154983,79165,5902,13670,42355,141092
u,u,1842,117,1385,197,30,45,50,322
u,f,1758,30,24,25,3,10,14,52
f,m,1774,44,3055,421,50,152,464,1087
f,u,2006,12044,761794,412715,27554,69654,231698,741621
f,u,1827,176,29042,3958,439,1204,2884,8485
u,f,2007,5989,64306,29736,2241,6078,6762,44817
f,u,1976,11632,935559,359754,27454,70057,200427,657692
m,f,1900,3348,373712,78269,6207,17418,42152,144046
m,f,1902,2420,303927,61009,4726,13285,34230,113250
f,u,1861,155,19089,3277,249,1008,3576,8110
u,u,1916,2513,83864,12845,942,3601,2242,19630
m,f,1824,749,163675,23987,1964,7334,17090,50375
f,u,1854,362,78115,12317,1024,3224,9126,25691
m,u,1805,11,110,65,8,21,88,182
u,m,2011,70,7555,1332,20,259,226,1837
m,f,1990,9221,540424,257789,18446,47910,119092,443237
u,m,1839,911,30480,2735,191,935,570,4431
m,m,1924,12366,1182511,394996,28801,78173,201719,703689
f,m,1957,4836,473509,178167,12128,32605,87724,310624
m,f,1717,0,0,0,0,0,0,0
m,f,1748,0,0,0,0,0,0,0
f,u,1995,13155,926417,393856,27973,74359,226960,723148
f,u,1975,10677,824299,347137,27274,71332,200162,645905
m,m,1983,16871,1331353,562247,35135,94780,251285,943447
f,f,1748,0,0,0,0,0,0,0
f,u,1726,0,0,0,0,0,0,0
u,f,1789,0,0,0,0,0,0,0
m,u,1708,0,0,0,0,0,0,0
u,m,1933,8120,222309,40107,2989,8608,7670,59374
u,m,1913,5044,145112,21215,1590,5628,4817,33250
m,u,1811,131,17825,3845,284,1110,3548,8787
m,m,2012,0,0,0,0,0,0,0
m,u,1869,346,40046,8782,779,2191,6350,18102
m,m,1896,14027,1598714,293294,23322,71849,169474,557939
u,u,1725,17,0,52,6,16,10,84
m,m,1864,3722,572132,85960,7381,25017,54855,173213
f,f,1706,0,0,0,0,0,0,0
m,f,1703,0,0,0,0,0,0,0
f,m,1833,633,89077,10962,976,3607,10308,25853
u,f,1817,288,12983,1673,114,591,471,2849
u,f,1772,143,10942,671,68,236,168,1143
m,f,1996,12840,939974,389796,26182,68933,171232,656143
m,u,1742,0,0,0,0,0,0,0
f,u,1718,0,0,0,0,0,0,0
m,m,1938,11161,1049301,367699,25472,66546,170974,630691
u,m,1907,4305,125361,17301,1165,4638,3603,26707
f,m,1929,4939,510308,184683,14191,38115,106077,343066
f,u,1830,522,64947,6946,733,2386,7155,17220
m,f,1840,1140,186845,27086,2349,8764,21150,59349
u,u,1717,0,0,0,0,0,0,0
m,m,1831,3727,560581,56166,4265,16038,46054,122523
m,u,1826,173,8186,2795,194,1040,2153,6182
f,m,1851,673,115272,17417,1406,5543,13731,38097
m,u,1893,968,93769,20691,1666,4885,12660,39902
m,m,1745,0,0,0,0,0,0,0
f,f,1818,442,76395,14142,1376,4675,12883,33076
m,f,1834,1113,217651,26511,2267,7935,17387,54100
f,u,2011,4,0,0,0,0,1,1
f,u,1730,0,0,0,0,0,0,0
m,m,1842,2161,440927,63893,4281,18551,42846,129571
u,u,1790,0,0,0,0,0,0,0
m,m,2001,20925,1188310,580549,37396,99622,269779,987346
u,m,1833,1090,45818,3467,277,1012,757,5513
f,m,1867,1066,207809,37181,3764,10184,26962,78091
m,m,1732,0,0,0,0,0,0,0
m,u,1863,530,79541,12179,1110,3017,7774,24080
f,m,1886,1918,342101,65469,5780,16713,44854,132816
m,f,1787,136,7252,1846,133,655,1457,4091
f,m,1861,529,95783,14641,1386,4190,11010,31227
u,f,1706,0,0,0,0,0,0,0
u,m,1766,3,0,2,0,1,3,6
f,u,1950,8055,916222,320986,25070,66231,184045,596332
m,u,1978,28492,1830133,707241,49015,132861,351024,1240141
u,u,1872,343,7488,873,79,288,253,1493
u,u,1891,489,10657,1904,163,511,432,3010
f,m,1880,2155,383906,58468,5054,15265,41656,120443
f,m,1900,2130,246351,56860,4680,13791,38203,113534
m,f,1941,4913,502444,168521,11979,32018,79325,291843
m,u,1817,136,8562,1882,194,706,1692,4474
m,m,1915,9752,1393037,289604,19642,62016,145452,516714
u,u,1713,0,0,0,0,0,0,0
u,f,1872,1133,34017,3404,334,1218,964,5920
f,u,1843,106,29208,3386,292,1144,3314,8136
m,u,2011,31,1795,34,8,23,0,65
u,u,1721,0,0,0,0,0,0,0
u,f,1832,478,16167,1176,117,453,352,2098
m,u,1969,38012,2425993,869958,65648,173459,447871,1556936
m,f,1848,990,183577,26362,2262,7124,17827,53575
u,f,1776,0,0,0,0,0,0,0
f,u,1856,345,80266,8901,779,2565,7596,19841
m,u,1953,21230,1416810,501033,35813,96277,246313,879436
f,m,1990,6694,535826,233418,15124,40689,122750,411981
f,f,1751,22,3117,1491,132,1064,1285,3972
m,m,2010,211,4497,3878,277,641,1745,6541
f,m,1985,5045,464729,189581,12471,32839,94862,329753
f,m,1717,0,0,0,0,0,0,0
f,f,1803,123,22452,3282,232,1277,3730,8521
f,f,1983,2605,253265,155574,10724,25695,76515,268508
f,m,1756,3,1070,138,15,82,113,348
m,m,1709,0,0,0,0,0,0,0
m,u,1830,1415,237543,24984,2187,8284,20414,55869
u,m,1979,10916,201096,57437,3660,10980,12920,84997
u,u,1734,0,0,0,0,0,0,0
f,m,1837,621,102907,14016,1234,4446,12844,32540
f,f,2012,0,0,0,0,0,0,0
u,m,1825,1389,46954,3846,321,1333,921,6421
u,f,1704,0,0,0,0,0,0,0
u,m,1795,43,188,37,6,17,5,65
f,m,1703,30,582,115,12,117,263,507
f,u,1879,513,115913,20130,1957,5346,15595,43028
f,m,1996,6188,499982,225903,14546,37753,122132,400334
f,u,1867,294,57774,10382,786,2413,7245,20826
f,m,1734,0,0,0,0,0,0,0
m,f,1794,88,8226,1856,172,619,1668,4315
u,u,1754,0,0,0,0,0,0,0
f,m,1730,0,0,0,0,0,0,0
m,u,1849,384,40861,7814,713,2053,5714,16294
m,m,1741,68,6160,1367,107,342,646,2462
u,u,1997,21982,419628,112988,8087,22697,24382,168154
u,f,1939,1701,33569,8852,679,1944,1959,13434
u,f,1954,2933,57155,16188,1206,3485,3486,24365
m,f,1851,1471,172641,28880,2877,8590,21479,61826
f,f,1745,0,0,0,0,0,0,0
u,u,1804,30,173,96,6,38,17,157
f,m,1916,2985,546636,124486,9661,26820,69271,230238
m,m,1948,14762,1335432,494468,33518,84351,221250,833587
f,m,1999,6054,479994,247732,16245,41904,131421,437302
m,u,1854,855,112405,15636,1357,3873,9274,30140
f,m,1989,6686,507207,245257,16586,43016,126727,431586
u,m,1790,18,0,27,5,12,3,47
m,u,1792,0,0,0,0,0,0,0
f,f,1732,0,0,0,0,0,0,0
u,f,1767,0,0,0,0,0,0,0
m,u,2006,29729,1482410,738784,49845,131706,359042,1279377
u,m,2003,10778,146451,54111,3713,11227,12005,81056
f,f,1974,2172,220013,96105,7101,17150,51922,172278
m,m,1973,18921,1281383,573504,37278,95212,265583,971577
u,m,1940,5561,114861,30690,2149,6408,6378,45625
f,m,1973,5817,378683,173070,12584,31961,88526,306141
u,u,1801,8,6,4,4,4,1,13
f,u,1952,6807,748703,256606,20422,51507,147321,475856
u,u,1820,52,1103,109,13,32,28,182
f,f,2003,6348,665602,356123,23769,58565,197010,635467
f,u,1991,14487,969499,458235,33881,87402,256623,836141
u,f,1802,51,8060,401,37,187,102,727
f,m,1940,3525,357328,142072,10187,26679,71271,250209
f,m,1935,5169,515833,195558,14956,37422,108955,356891
f,f,1993,5455,504717,266270,17686,43972,143831,471759
f,u,1889,350,52703,10559,922,2498,8555,22534
u,m,1851,1093,44860,3836,309,1459,520,6124
f,m,1898,3904,713803,122873,9798,30862,80879,244412
f,u,1758,0,0,0,0,0,0,0
f,m,1848,806,135904,18926,1487,5702,16551,42666
u,f,1805,74,1479,260,15,99,37,411
u,u,1811,109,8015,581,41,199,89,910
u,f,2006,5730,108928,41539,2725,7452,9019,60735
u,m,1726,83,15,76,6,27,12,121
u,f,1827,500,10154,1197,100,483,307,2087
f,u,1806,1,0,6,1,1,1,9
m,m,1751,155,2998,1270,120,468,933,2791
u,f,1923,1178,22898,5816,499,1427,1266,9008
u,f,1909,1994,54780,8096,693,1957,1808,12554
m,f,1887,4371,555556,112029,10390,27764,65945,216128
f,u,1850,16,1484,278,26,70,251,625
u,f,1780,0,0,0,0,0,0,0
m,f,1897,4369,653577,124976,10881,28861,72466,237184
f,m,1991,6757,494591,250243,16897,43289,134118,444547
m,u,1864,971,117048,17175,1553,4220,10231,33179
m,m,1946,16762,1375488,506055,34804,87139,226180,854178
f,f,1977,2401,236271,110536,7890,19668,57785,195879
u,u,1956,13853,327346,78161,5293,16703,15933,116090
u,m,1931,5288,127707,27798,1995,6511,5783,42087
m,f,2012,0,0,0,0,0,0,0
m,m,1765,0,0,0,0,0,0,0
f,u,1982,11352,878048,363626,27760,68801,192304,652491
m,u,1918,4265,367557,89145,6129,20787,41389,157450
u,m,1956,9343,155029,43953,3058,9073,7932,64016
f,u,1778,0,0,0,0,0,0,0
m,u,1995,32357,1579556,682962,49012,132994,341471,1206439
f,f,1749,0,0,0,0,0,0,0
u,m,1750,67,0,101,15,46,26,188
m,f,1895,4290,594777,107439,9162,26239,57435,200275
f,f,1804,129,7032,3311,341,957,2417,7026
u,u,1748,13,0,15,1,6,2,24
f,f,1870,1414,363047,65478,5804,15930,47835,135047
m,m,1784,656,17264,5461,530,1947,4605,12543
m,u,1958,18158,1335097,527138,36299,98337,257371,919145
m,m,1795,109,21384,2652,206,980,2585,6423
f,m,1794,6,24,19,3,10,41,73
m,f,1876,3015,465338,84220,7551,21071,50387,163229
m,m,1734,0,0,0,0,0,0,0
u,u,1862,175,4217,328,39,107,99,573
u,f,1863,722,16075,1948,182,606,434,3170
u,m,1862,1522,42228,5053,447,1398,790,7688
m,u,1751,21,27,99,13,37,63,212
f,m,1866,1498,270733,40623,3744,11590,31508,87465
f,f,1731,0,0,0,0,0,0,0
m,m,1740,100,13175,1876,98,735,1250,3959
u,f,1921,1785,66079,9717,742,2390,2198,15047
f,u,1817,75,9578,2241,186,1049,1892,5368
f,u,1980,10504,744221,322160,24165,60220,176378,582923
m,f,1916,4248,625617,133951,10425,28709,67794,240879
u,m,1725,0,0,0,0,0,0,0
u,m,1947,9782,171198,45541,3317,9721,9354,67933
u,m,1791,77,2007,371,32,97,73,573
f,m,1922,5116,829324,199669,15534,41193,114925,371321
u,f,1830,314,14831,929,102,364,252,1647
f,u,1877,213,30050,5320,478,1347,3895,11040
m,u,1759,0,0,0,0,0,0,0
m,m,1717,0,0,0,0,0,0,0
m,f,1842,1139,132755,21412,1955,6337,15976,45680
m,f,1983,5048,258243,163748,11895,29773,72840,278256
f,u,1809,17,519,245,30,87,215,577
u,f,1738,0,0,0,0,0,0,0
m,f,1814,863,80549,19426,1582,5777,16775,43560
m,m,1787,77,4371,842,82,239,783,1946
m,u,2001,26592,1392833,603275,42154,111600,302125,1059154
m,f,1890,4351,565311,109539,10047,27349,65456,212391
f,u,1922,3197,324014,102007,7617,23442,57608,190674
m,m,1971,19520,1361679,565683,36786,95442,255921,953832
m,f,1885,2997,448968,85779,7878,21595,47289,162541
u,f,1747,0,0,0,0,0,0,0
u,f,1869,1108,39084,4124,387,1268,1002,6781
m,m,1761,32,1041,1366,112,445,1035,2958
m,u,1955,22182,1771227,628239,43991,115642,307373,1095245
m,u,1871,575,66096,11473,1085,2854,6951,22363
m,f,1914,4499,639067,139395,10348,30207,73252,253202
m,m,1993,19426,1231600,586012,37977,100457,264550,988996
m,m,1900,6332,690243,141203,10850,33806,80844,266703
f,m,1933,4205,418978,151226,12466,30332,84385,278409
m,u,1786,0,0,0,0,0,0,0
m,f,1910,4784,639712,125043,10339,27363,67199,229944
u,m,1945,5984,110966,29057,1968,5908,5025,41958
u,m,1966,11697,193320,63383,3934,11843,12894,92054
f,u,1716,0,0,0,0,0,0,0
m,m,1851,2326,359641,52152,3809,16376,32794,105131
f,u,1860,455,78043,12835,1099,3642,10718,28294
m,u,1884,336,46216,9506,1021,2483,4820,17830
u,m,2008,9138,115276,48605,2935,8731,11411,71682
m,m,1748,15,0,42,3,10,31,86
m,f,1991,10024,537118,283542,20496,51072,127572,482682
u,u,1736,0,0,0,0,0,0,0
m,u,1788,22,980,363,45,120,259,787
f,f,1840,750,192767,27277,2305,8669,23641,61892
u,m,1707,0,0,0,0,0,0,0
m,f,1959,4306,375797,139699,9966,24882,61614,236161
u,m,1987,9391,128843,48699,3054,9012,10109,70874
u,m,1867,1374,37858,4382,413,1316,926,7037
m,f,1718,0,0,0,0,0,0,0
f,m,2012,0,0,0,0,0,0,0
u,u,1751,29,0,27,1,17,5,50
u,m,1914,4806,126892,18346,1544,5153,4097,29140
m,f,1907,3812,424128,89888,6995,19395,49287,165565
f,f,1734,0,0,0,0,0,0,0
m,f,1929,4542,385467,140758,11529,28729,74825,255841
m,u,1964,24658,1737669,657968,46613,126984,326605,1158170
u,m,1959,9835,226676,56884,3336,10618,10383,81221
u,m,1938,5696,100838,28066,2072,5956,5730,41824
u,f,1904,1671,59275,7921,541,1807,1606,11875
f,f,1898,2620,582202,96778,8450,22553,68540,196321
m,f,1831,669,81215,10965,958,3300,8344,23567
f,m,1883,3932,541750,104197,10104,27611,74398,216310
f,f,1959,2233,283175,114138,7578,18796,56812,197324
m,m,1818,630,57287,6465,575,2099,4771,13910
u,u,1795,15,1095,86,5,16,29,136
m,m,1923,12466,1235028,398927,29190,79866,214727,722710
f,f,2001,6295,672050,331715,21520,53546,176367,583148
m,m,1944,10422,858633,309400,21669,53353,139030,523452
f,f,1717,0,0,0,0,0,0,0
f,f,1989,5189,425067,266655,17758,43229,136635,464277
u,u,1922,5193,82208,22745,1830,5889,5249,35713
m,f,1867,3125,509426,80950,7394,21570,48556,158470
f,m,1983,5011,387810,182388,12069,31857,94236,320550
m,u,1731,0,0,0,0,0,0,0
f,m,1824,478,53262,8017,702,2654,7853,19226
u,m,1952,8641,168627,46076,3256,9587,9849,68768
f,m,1781,23,276,80,11,58,80,229
f,u,1984,10719,729586,357152,26017,65057,198909,647135
m,f,1861,1227,105020,20409,2001,5471,13219,41100
u,m,1991,11315,198753,62941,4340,13486,13846,94613
u,m,2001,10522,164479,54115,3351,10060,11865,79391
f,m,2004,7802,510349,280593,18766,48276,148087,495722
u,m,1937,6997,110207,28221,2139,6490,5949,42799
u,u,1930,13008,326167,72716,5120,16348,15221,109405
m,f,1935,5787,469369,170036,13343,33657,85402,302438
m,f,1714,0,0,0,0,0,0,0
u,m,1762,306,9691,184,5,135,31,355
u,u,1888,357,10610,1359,148,400,401,2308
u,m,1787,27,13,30,1,10,11,52
f,u,1883,227,27428,5008,452,1362,3733,10555
m,m,1797,166,11135,1467,124,555,1017,3163
u,m,1908,3844,112580,18430,1333,4355,3386,27504
m,f,1968,5168,416691,176694,12769,32800,79057,301320
m,f,1744,0,0,0,0,0,0,0
f,u,1888,373,56987,9495,830,2195,7387,19907
f,u,1767,0,0,0,0,0,0,0
f,f,1915,3313,836653,160259,11848,32891,98617,303615
f,u,1875,134,23137,4914,497,1182,3587,10180
f,f,1900,2055,347251,68913,5836,15715,44838,135302
m,u,1911,3947,434348,77372,5510,20402,36144,139428
m,f,1933,4098,345184,130314,10187,25809,64924,231234
m,f,1936,5972,482727,177558,14219,36167,85840,313784
u,u,1918,2141,34446,7383,559,1998,1309,11249
f,m,1771,0,0,0,0,0,0,0
f,u,1884,180,26870,6663,688,1644,3990,12985
f,f,1960,2550,287135,124688,8815,20804,62074,216381
m,u,1752,22,0,213,24,69,124,430
m,f,1985,7333,478359,212464,14873,37654,97614,362605
f,u,1931,5710,476834,192456,16166,41101,116474,366197
f,m,1926,3864,487777,156497,12536,31424,91329,291786
u,u,1909,1448,48021,6666,490,1713,1152,10021
u,f,1835,977,18619,1928,194,626,539,3287
u,m,1982,10184,215791,62044,3871,11631,12721,90267
u,u,1838,105,2701,175,17,44,42,278
m,u,1821,234,25095,5743,422,1767,5360,13292
m,m,1815,507,58802,7698,631,2308,6088,16725
f,u,1750,0,0,0,0,0,0,0
m,u,1929,19630,1407090,473453,36556,104528,261379,875916
u,u,1707,0,0,0,0,0,0,0
f,u,1957,8017,835590,319620,24589,61107,167414,572730
f,m,1718,0,0,0,0,0,0,0
u,m,1819,442,15021,862,73,281,309,1525
u,m,1773,8,0,10,1,2,0,13
u,u,1773,0,0,0,0,0,0,0
f,u,1909,920,133596,28401,2194,6262,18159,55016
u,u,1724,0,0,0,0,0,0,0
u,u,1731,0,0,0,0,0,0,0
f,f,1814,535,114367,22651,1791,7373,21425,53240
m,m,1857,4740,800850,98283,7849,27795,67089,201016
u,m,1782,27,63,48,8,19,7,82
m,u,1822,498,48657,5170,318,2030,4598,12116
u,f,1729,0,0,0,0,0,0,0
m,f,1730,0,0,0,0,0,0,0
u,m,1910,5491,112840,17210,1285,4807,4068,27370
u,f,1947,2353,36645,11152,862,2389,2389,16792
m,m,1914,10906,1637490,322365,23774,68924,159857,574920
f,u,1834,130,22784,2610,194,751,2486,6041
u,f,1999,5695,76858,29989,2118,6212,7611,45930
f,f,1933,2111,249463,109699,8035,19077,62769,199580
u,f,1888,1503,49549,6684,670,1980,1762,11096
m,f,1953,5456,503532,191703,13870,34844,83469,323886
m,u,1877,419,46866,8454,737,1927,5358,16476
f,u,1997,12823,808311,384060,27780,72198,216865,700903
f,m,1819,203,38757,3815,342,1110,3684,8951
m,f,1883,3799,441911,96865,9645,24002,54734,185246
m,m,1840,3646,499887,69976,5408,20886,49672,145942
f,u,1753,0,0,0,0,0,0,0
m,f,1989,9070,501789,274220,18781,49907,120627,463535
m,u,1837,167,20730,2506,182,793,1900,5381
f,m,1804,192,15955,3356,289,1093,2979,7717
u,m,1818,290,7175,488,43,197,137,865
u,u,1836,68,4239,431,38,178,73,720
u,m,2007,10382,155911,50909,3268,9994,10928,75099
f,u,1791,8,0,12,0,3,13,28
f,m,1881,1507,319801,59521,5649,14790,40217,120177
m,f,2004,11320,822186,375053,26223,67125,167960,636361
f,u,1958,5812,522449,204917,14920,39125,112731,371693
m,u,1946,23870,1766578,618137,45559,114795,299500,1077991
m,f,1973,5180,325906,152839,11669,28704,70862,264074
m,u,1713,0,0,0,0,0,0,0
u,u,1849,151,2664,260,16,78,53,407
m,m,2003,21415,1494073,652026,41641,109562,294424,1097653
f,m,1862,640,86098,14669,1301,4150,12227,32347
u,f,1855,820,31031,2156,188,684,386,3414
f,f,1797,82,18173,3218,255,1132,2974,7579
m,f,1849,1074,147230,24486,2038,6950,18911,52385
f,m,1744,0,0,0,0,0,0,0
f,u,1990,15724,1053314,489013,35669,88309,270503,883494
m,f,1898,4810,597891,112892,9772,26544,65394,214602
f,f,1949,2703,425925,154628,10740,25290,77712,268370
u,u,1882,1112,21971,2394,203,642,636,3875
u,m,1789,44,1142,332,23,102,97,554
u,u,1835,121,3315,263,29,102,100,494
f,u,1988,12984,908152,402206,30271,75153,225613,733243
u,m,1893,6657,295216,34382,2238,10280,4955,51855
f,m,1992,5862,443596,211505,13988,36054,106823,368370
f,u,1707,0,0,0,0,0,0,0
u,m,1706,0,0,0,0,0,0,0
u,f,1809,279,7101,950,79,328,247,1604
u,f,1932,1685,27804,7675,664,1762,2003,12104
m,f,1923,2422,242407,76104,5802,15386,37682,134974
f,m,1887,2044,328624,64880,5997,15438,43930,130245
m,f,1926,3442,283991,96177,7538,19428,48549,171692
u,m,1716,0,0,0,0,0,0,0
f,u,1968,12150,965207,397690,29246,79147,224547,730630
f,m,1897,2776,544167,97366,7728,23595,63407,192096
m,f,2006,11560,812415,420458,29383,75152,195684,720677
m,u,1965,28887,1820545,741936,53678,142235,358599,1296448
f,f,1858,966,290064,46213,3952,12236,35726,98127
u,u,1798,0,0,0,0,0,0,0
u,u,1746,0,0,0,0,0,0,0
m,u,1990,39439,2060951,880864,63970,165888,444171,1554893
f,u,1955,6813,781333,263147,18949,49470,144008,475574
u,u,1919,1750,33246,6157,551,1568,1380,9656
m,m,1999,19712,1395596,612379,37436,104872,280867,1035554
u,u,1898,322,5079,736,84,257,228,1305
m,f,1799,215,32720,5418,545,1969,4752,12684
u,f,1751,12,66,60,6,19,9,94
u,u,1954,11783,312432,81351,4959,16063,15461,117834
m,f,1860,2399,281092,49358,4508,13186,32960,100012
f,u,1771,0,0,0,0,0,0,0
m,m,1870,3804,625164,95628,7689,26529,60311,190157
f,f,1784,25,3616,678,73,297,440,1488
f,f,1795,90,24624,6293,353,1877,5168,13691
u,u,1860,495,36018,2661,240,866,526,4293
f,f,1724,0,0,0,0,0,0,0
f,m,1753,8,89,86,9,64,70,229
m,m,1883,10395,1185323,204125,18658,54002,129951,406736
m,f,1866,2553,420225,66912,6315,17197,42525,132949
u,m,1724,0,0,0,0,0,0,0
m,m,1933,12804,1189983,402208,28852,76097,195236,702393
f,f,1740,0,0,0,0,0,0,0
m,m,1910,11640,1572699,308547,21984,69798,159204,559533
u,u,1781,4,15,3,1,4,1,9
u,u,1868,431,6600,1339,122,447,190,2098
u,u,1828,139,4489,257,22,81,63,423
u,f,1795,104,4613,996,70,354,187,1607
m,f,1922,6271,778682,185624,14760,39675,94286,334345
f,m,1708,25,1018,175,23,88,298,584
m,u,1972,27403,1753421,656397,47616,126069,318260,1148342
m,u,1999,30095,1494331,703462,48627,130834,347415,1230338
f,f,1902,1403,300854,54812,4465,11757,34647,105681
f,m,1814,8,0,37,3,7,47,94
f,u,1868,538,121460,22944,1765,5709,15833,46251
m,f,1756,0,0,0,0,0,0,0
f,u,1880,248,24243,5577,533,1386,4537,12033
m,u,1895,932,91072,20157,1708,4820,11353,38038
f,f,1935,2973,383653,152205,11547,28475,86024,278251
u,f,1882,1585,61953,8446,717,2449,2133,13745
f,u,1865,424,65950,12013,1042,2850,8367,24272
f,f,1761,0,0,0,0,0,0,0
f,m,1849,764,89155,14930,1487,4641,12337,33395
u,u,1969,23949,400656,109676,8205,24009,22672,164562
m,f,1761,0,0,0,0,0,0,0
f,m,1914,3847,812804,164747,12321,35133,94419,306620
u,m,1983,9753,259078,64791,3812,11734,13236,93573
u,u,1703,0,0,0,0,0,0,0
m,m,1949,15383,1385362,480929,32593,83551,213642,810715
f,m,1910,3409,539581,109123,8372,24092,66602,208189
u,m,1705,0,0,0,0,0,0,0
m,m,1972,16075,1026578,461108,30049,79888,206620,777665
u,u,1850,54,5146,371,14,117,45,547
u,f,2003,5859,108415,38529,2598,7089,8688,56904
f,m,1879,898,174898,34359,2951,8689,23245,69244
m,u,1753,0,0,0,0,0,0,0
f,f,1831,381,93755,12986,1131,4057,12014,30188
m,u,1758,0,0,0,0,0,0,0
f,f,1766,11,0,101,15,40,116,272
m,m,1738,0,0,0,0,0,0,0
u,f,1711,0,0,0,0,0,0,0
m,u,1814,40,7755,994,92,298,679,2063
f,m,1865,1125,203916,31095,2580,8498,22481,64654
u,m,1884,3150,60758,8842,767,3030,2024,14663
m,u,1740,0,0,0,0,0,0,0
f,f,1999,6580,760009,367372,24132,59795,197980,649279
u,f,1785,127,1700,825,54,263,111,1253
m,f,1899,5459,780889,128971,11237,29870,71223,241301
u,u,1933,7455,124017,31363,2446,7635,6477,47921
m,f,1833,1262,163714,27362,2493,8418,20173,58446
m,u,1950,21911,2098398,703362,49887,143538,357795,1254582
m,m,1838,1608,198185,26978,2154,8227,20537,57896
u,f,1726,0,0,0,0,0,0,0
u,m,1909,4082,99845,15431,1167,3979,3617,24194
f,f,1790,0,0,0,0,0,0,0
u,f,1745,0,0,0,0,0,0,0
u,m,1870,2055,64304,7496,660,2304,1359,11819
u,m,1757,0,0,0,0,0,0,0
m,m,1898,12031,1825491,305226,22659,76430,177583,581898
f,m,1831,817,162248,17339,1370,5238,16476,40423
f,u,1961,9217,816153,323295,24360,60303,180333,588291
m,f,1705,0,0,0,0,0,0,0
u,m,1891,3854,130321,15947,1495,4326,3285,25053
f,m,1705,0,0,0,0,0,0,0
f,f,1923,1279,151234,60301,4904,11958,34597,111760
f,f,1869,1576,361707,67474,6367,15757,49079,138677
f,f,1951,3109,514057,172140,11726,28415,85076,297357
f,u,1826,56,7596,1402,81,540,1330,3353
f,u,1947,7536,864133,298006,22596,53625,160075,534302
u,f,1927,1969,35830,9521,925,2463,2523,15432
f,u,1946,7523,636785,249955,19675,46939,135834,452403
u,m,1873,1560,57852,5499,489,1695,1196,8879
m,u,1968,41082,2259417,903660,66147,186729,446461,1602997
f,u,1849,163,14220,2885,271,843,2454,6453
f,m,1889,2269,337682,67973,5917,16809,46042,136741
u,u,1910,2554,51292,9022,687,2323,1827,13859
m,u,1906,2271,283796,55419,4192,13206,28785,101602
u,f,1862,520,18686,2414,203,691,627,3935
u,u,1766,0,0,0,0,0,0,0
u,f,1842,551,16665,2139,180,771,387,3477
m,m,1721,0,0,0,0,0,0,0
f,f,1705,0,0,0,0,0,0,0
f,f,1890,2278,442903,87709,8123,20742,62374,178948
u,f,1750,0,0,0,0,0,0,0
m,u,1724,0,0,0,0,0,0,0
u,f,1962,2757,39990,14017,967,3201,2643,20828
u,u,1871,181,2973,410,33,145,93,681
u,m,1958,8079,143240,44374,3382,9251,8493,65500
m,f,1797,94,19491,3224,244,992,2621,7081
f,u,1811,72,12413,2273,166,721,2542,5702
u,m,1890,4485,162013,16004,1347,4879,3359,25589
u,f,1783,0,0,0,0,0,0,0
u,m,1780,24,0,10,2,12,7,31
f,m,1936,3580,403182,148998,11469,27763,81764,269994
m,m,1807,160,9938,2537,186,853,2195,5771
f,m,1949,4713,460461,169159,12734,31091,85468,298452
u,m,1744,0,0,0,0,0,0,0
u,u,1711,0,0,0,0,0,0,0
f,f,1972,1759,170907,73921,5222,12927,38482,130552
m,m,1960,16658,1343996,519829,35721,90841,225946,872337
u,f,1816,262,5463,777,63,286,162,1288
f,u,1956,7533,755236,278832,21312,54741,151171,506056
u,m,1978,10301,174627,56203,3534,10474,10830,81041
m,u,1791,22,100,183,13,55,128,379
u,f,1985,3577,81080,24988,1695,4938,5927,37548
f,f,1738,0,0,0,0,0,0,0
f,u,1965,9391,714586,293283,23266,58628,160563,535740
m,f,1865,2944,408515,70513,6496,18098,43003,138110
u,m,1846,1369,25094,2951,280,1073,577,4881
m,m,1904,7203,888491,170160,12654,39504,90484,312802
u,m,1994,10118,172668,51622,3447,10215,11625,76909
m,f,1821,398,61076,13952,1002,4144,12422,31520
u,m,1738,0,0,0,0,0,0,0
u,m,1926,6039,197354,29886,2277,6698,6103,44964
m,u,1774,12,16,37,4,10,45,96
m,u,1862,533,78166,13178,1381,3483,8174,26216
f,m,1899,4761,746759,133617,10946,32326,90599,267488
f,u,1932,4246,401539,158003,12322,31485,92207,294017
u,f,1803,86,2543,418,40,158,110,726
m,m,1820,689,68529,9665,762,2873,7096,20396
f,f,1838,635,139883,17754,1568,5643,17982,42947
u,m,1771,0,0,0,0,0,0,0
f,f,1857,1376,340602,61142,5499,16420,48377,131438
u,m,1955,9845,184575,54938,3737,10637,10054,79366
m,f,1798,204,12450,2470,231,785,2042,5528
u,u,2012,0,0,0,0,0,0,0
f,f,1914,2682,652366,122182,9015,25011,74624,230832
f,u,1828,172,29670,4359,343,1143,2738,8583
f,f,1779,18,2623,201,29,87,240,557
m,f,1945,5257,563180,177344,12363,31038,78631,299376
m,m,1788,258,21328,4199,347,1515,2737,8798
u,f,1879,995,32426,4017,416,1146,1008,6587
u,f,1886,1914,65932,8163,772,2279,2019,13233
m,f,1819,255,23273,4179,377,1386,3169,9111
m,f,1752,0,0,0,0,0,0,0
u,m,1974,10446,171694,52453,3341,10767,10236,76797
u,f,1867,1459,37555,3806,376,1208,901,6291
m,u,1709,0,0,0,0,0,0,0
u,f,1851,582,13113,1361,132,536,481,2510
m,u,1917,3428,353081,79986,6177,18476,40203,144842
u,u,1879,703,21023,1811,181,556,327,2875
u,f,2000,5552,87835,33051,2268,6367,7919,49605
m,f,1782,0,0,0,0,0,0,0
f,u,1936,5509,524636,182238,14231,33804,101942,332215
u,u,1821,74,398,81,8,46,24,159
u,u,1788,4,39,5,0,0,0,5
f,m,1854,1183,155498,22168,1976,6589,19167,49900
u,m,1865,1608,39120,4320,365,1385,1018,7088
f,m,1882,1922,271240,60282,5483,15113,42775,123653
f,m,1759,12,486,82,3,64,68,217
u,f,1959,2393,64159,17180,1143,3270,3602,25195
f,f,1925,1777,233137,93102,7146,18664,54883,173795
f,f,1912,3095,648857,124118,9737,26230,78491,238576
f,m,1845,751,121622,17880,1460,5371,15215,39926
f,u,1781,8,68,20,3,19,60,102
f,m,1754,5,0,4,0,3,6,13
u,m,1868,1638,43538,5348,486,1733,1115,8682
f,m,1967,6340,498794,226783,16150,41875,116791,401599
f,m,1775,0,0,0,0,0,0,0
f,u,1926,5526,531935,184058,15243,40678,111862,351841
f,m,1797,45,2052,250,42,146,304,742
f,m,1890,2602,473193,86201,7715,21759,59873,175548
m,u,1757,0,0,0,0,0,0,0
u,m,1921,5589,156689,26770,1983,6658,6332,41743
u,m,1877,2333,87531,8115,651,2477,1950,13193
f,f,1807,215,27888,8318,526,3138,9308,21290
m,f,1949,5121,496032,167314,12308,29672,76539,285833
m,f,1998,10815,729392,330456,23619,61693,159601,575369
u,f,1952,3122,59550,17464,1327,4024,4242,27057
m,u,1915,2906,365263,81000,5831,19932,39422,146185
u,u,1792,0,0,0,0,0,0,0
m,f,1992,10380,663113,318860,22399,56959,145227,543445
m,u,1989,35308,1727736,805841,57883,152406,391902,1408032
m,u,1979,31201,1908928,734964,52838,140724,348747,1277273
m,m,1962,17128,1388490,548682,36205,93169,228756,906812
u,m,1720,0,0,0,0,0,0,0
u,u,1720,0,0,0,0,0,0,0
f,m,1923,4249,513751,174916,13969,36182,104461,329528
f,f,1713,0,0,0,0,0,0,0
u,m,1935,8654,182762,49637,3519,10440,10397,73993
u,u,1704,0,0,0,0,0,0,0
u,u,1784,13,25,12,4,5,5,26
f,u,1722,4,0,23,1,6,13,43
u,m,1734,0,0,0,0,0,0,0
m,m,1890,7873,1193391,184799,15263,46392,113490,359944
m,m,1858,2724,399946,55316,4556,16170,36661,112703
m,m,2006,21417,1211161,611774,39106,104473,285940,1041293
f,u,1728,0,0,0,0,0,0,0
f,u,1779,5,0,19,1,7,23,50
f,m,1858,860,151113,22525,1993,7204,17495,49217
u,m,1703,273,7374,429,41,219,44,733
m,u,1976,33946,2043804,786523,57963,154822,384668,1383976
f,f,1716,0,0,0,0,0,0,0
u,f,1960,2861,42878,13324,1035,3021,2882,20262
u,f,1938,2466,37970,12549,907,2845,2824,19125
u,u,1975,19795,386738,99270,7178,21262,19624,147334
f,m,1860,1039,165364,26791,2399,7885,23196,60271
m,u,1769,39,1564,615,83,234,426,1358
m,f,1862,1334,189616,32400,2922,9041,18558,62921
u,u,1945,9089,212232,47388,3254,10016,8980,69638
m,u,1840,309,26614,4279,349,1384,3825,9837
f,m,1728,11,382,119,7,37,95,258
f,f,1798,181,16353,2764,302,1007,3211,7284
u,u,1839,184,5544,474,40,214,100,828
u,m,1960,8486,156683,44736,2817,8690,8440,64683
m,m,1975,16263,1282263,544851,34117,93049,247953,919970
f,f,1788,0,0,0,0,0,0,0
u,m,1876,2227,81675,8853,801,2595,1535,13784
f,f,1910,2742,616993,120901,9529,24297,77715,232442
f,f,1964,2405,245189,110167,8437,18879,52854,190337
u,u,1760,11,0,28,3,8,9,48
f,m,1752,38,433,1538,156,867,1576,4137
m,f,1784,42,11138,1366,129,523,675,2693
f,m,1878,1984,240398,47630,4382,12418,35313,99743
u,m,1763,89,476,127,16,47,39,229
m,u,1894,605,59970,14908,1377,3325,9044,28654
u,f,1916,1995,48313,8198,678,2121,1922,12919
m,u,1721,0,0,0,0,0,0,0
u,u,1965,20442,348042,103898,7110,22377,20970,154355
u,m,1900,3700,106974,14051,1014,4264,2820,22149
m,f,1882,3196,456886,88671,7541,21611,48852,166675
m,u,1908,4866,297400,61946,4184,14196,33969,114295
m,m,1821,760,83974,13234,997,3696,10449,28376
m,m,1832,1417,266310,34163,2905,10418,26025,73511
m,m,1830,2228,306474,38503,3046,11963,32789,86301
m,m,1925,11495,1195884,364078,27265,72544,196093,659980
m,u,1808,126,13476,1724,175,573,1251,3723
f,f,1852,1009,278852,45852,3570,11390,39539,100351
f,m,1885,1811,271981,50986,4311,13115,34990,103402
u,f,1718,0,0,0,0,0,0,0
m,f,1845,2673,335305,47144,4373,15831,43845,111193
f,u,1836,111,7886,1541,186,481,1523,3731
m,f,1754,0,0,0,0,0,0,0
u,m,1941,5314,100555,25535,1834,5637,5845,38851
m,f,1967,4408,289208,129555,9828,24403,57769,221555
m,f,1775,16,383,186,19,80,189,474
f,m,1761,28,1887,1337,121,793,1336,3587
m,u,1784,28,2209,237,19,96,160,512
m,f,1788,0,0,0,0,0,0,0
m,f,1877,2677,334832,64263,6064,16011,39702,126040
f,f,1945,2746,411265,143066,9884,24213,76711,253874
f,u,1842,80,9033,1277,101,386,1260,3024
f,f,1844,690,172610,23179,2128,6823,19438,51568
m,u,1900,27288,3164474,673011,52307,162580,384995,1272893
f,u,1712,0,0,0,0,0,0,0
u,u,1737,0,0,0,0,0,0,0
m,f,2002,11560,793263,360722,25565,63817,164036,614140
f,u,1810,69,4563,1026,83,348,1123,2580
m,f,1954,6246,516381,201236,14380,38120,96125,349861
u,u,1875,203,2653,576,55,191,132,954
f,m,1976,4990,396433,186038,12322,32758,94315,325433
m,m,1713,0,0,0,0,0,0,0
f,u,1744,2,0,10,1,7,15,33
u,u,1883,339,9865,1033,96,348,293,1770
u,m,1871,2028,56688,6727,613,2223,1164,10727
u,u,1938,8316,125887,40097,2899,8759,7857,59612
m,f,1852,1655,273871,40058,3370,10195,27507,81130
u,f,1874,958,29595,3741,327,1073,981,6122
u,f,1794,40,308,47,7,12,8,74
u,u,1946,14732,329713,67719,4921,15049,13406,101095
f,f,1876,2021,463530,81434,7431,19348,58371,166584
f,u,1714,0,0,0,0,0,0,0
m,u,1902,2981,254760,50036,4010,12395,28728,95169
u,u,1854,432,16969,1336,108,481,308,2233
f,u,1846,190,39354,4422,439,1604,4237,10702
u,u,1794,15,10,26,3,8,2,39
m,f,1820,654,71915,17838,1513,5397,12577,37325
f,u,1823,91,21768,3566,301,996,2987,7850
f,m,1873,1075,210643,34011,3059,9367,25346,71783
f,u,1897,232,29230,5634,507,1325,3720,11186
u,m,1769,32,0,20,3,10,2,35
f,m,2011,32,4590,1139,25,172,509,1845
u,m,1932,5760,116250,29286,1991,6525,6264,44066
u,f,1949,2263,43319,12645,944,2517,2517,18623
u,u,1767,0,0,0,0,0,0,0
u,m,1930,7935,154744,36327,2583,8425,7619,54954
m,u,1725,12,0,191,11,66,145,413
u,f,1818,292,9779,1223,119,429,433,2204
f,u,1887,191,35532,5804,528,1397,4626,12355
m,u,1794,65,8650,1717,172,494,1412,3795
m,m,1964,18562,1529187,613079,40210,102499,270272,1026060
f,f,1833,722,159141,24457,2112,7429,21706,55704
f,u,1918,1416,212227,44406,3128,10594,23375,81503
u,u,1787,2,0,2,1,1,0,4
f,m,1962,5585,498018,185006,13293,33765,90345,322409
m,f,1832,1307,168457,28501,2485,7924,21267,60177
m,m,1951,16836,1655303,604205,40640,104625,265782,1015252
u,u,1902,1780,50854,6744,548,1773,1464,10529
m,f,1878,3031,444157,75177,7038,17601,44538,144354
f,f,1770,16,3192,179,20,88,208,495
m,u,1851,489,47252,5851,535,1642,4547,12575
f,u,1785,9,316,157,11,46,73,287
m,m,1891,6584,842869,158444,14088,38003,90529,301064
u,u,1771,0,0,0,0,0,0,0
f,u,1974,8405,555431,267335,21186,54462,155743,498726
m,f,1889,4314,674190,123345,11682,29916,70607,235550
f,u,1901,1083,185411,32969,2829,7543,22570,65911
u,u,1915,1861,53158,9544,734,2378,1730,14386
f,m,1735,2,0,0,0,0,0,0
u,m,1894,6306,166771,20805,1646,6160,3828,32439
u,u,1757,0,0,0,0,0,0,0
u,f,1854,702,15173,1874,214,635,380,3103
f,f,1789,0,0,0,0,0,0,0
f,f,1721,0,0,0,0,0,0,0
m,m,1852,4445,667757,89397,7715,25631,63040,185783
u,u,1897,344,19571,1482,117,302,336,2237
f,f,1894,2630,649273,109044,9392,25313,77338,221087
m,u,1737,0,0,0,0,0,0,0
m,u,1907,2638,251538,58660,4437,14348,31135,108580
f,u,1723,0,0,0,0,0,0,0
m,f,1786,74,18169,2426,212,944,1726,5308
u,u,1764,0,0,0,0,0,0,0
m,u,1866,319,34734,6165,659,1653,3725,12202
f,u,1905,1048,146271,27083,2162,6674,16762,52681
m,u,1952,19088,1658966,570145,42854,114693,285775,1013467
u,f,1981,2936,46228,16234,1084,3259,4034,24611
m,u,1962,28171,2160583,761637,53359,150020,377341,1342357
u,u,1912,3476,76910,14704,1212,3977,3696,23589
f,f,1990,5092,410883,229810,15810,37977,122899,406496
f,f,1755,0,0,0,0,0,0,0
f,f,1888,2016,392227,78052,7329,19054,56360,160795
m,u,1993,37867,1658467,863502,63714,163391,423904,1514511
m,u,1922,8253,572942,202321,14526,45645,100030,362522
f,m,2002,6352,503865,238507,15141,40421,128207,422276
f,m,1905,2142,342419,66606,5206,14912,41575,128299
m,u,1723,0,0,0,0,0,0,0
f,f,1878,1576,350516,69070,6337,15911,50835,142153
m,f,1823,576,80948,15378,1372,5051,12039,33840
f,f,1772,10,68,13,1,9,45,68
m,m,1782,33,1021,396,37,157,323,913
f,u,1706,0,0,0,0,0,0,0
m,m,1853,4250,358797,48011,3956,14362,34496,100825
u,f,1821,218,11174,1286,82,464,511,2343
m,u,2000,32152,1453531,677412,49054,132098,337076,1195640
m,m,1737,0,0,0,0,0,0,0
f,m,2009,4436,228618,165435,10869,28502,83808,288614
u,u,1859,243,4126,511,62,172,112,857
u,f,1934,2298,32750,9673,893,2403,2168,15137
u,f,1724,0,0,0,0,0,0,0
u,m,1859,2629,102414,7778,648,2271,1550,12247
f,f,1820,379,61021,18881,1319,5939,14673,40812
f,u,1835,123,22331,2497,198,782,1965,5442
f,m,1970,7261,520832,227199,16433,41885,116644,402161
m,u,1825,421,50978,7100,828,2092,5764,15784
m,m,1777,57,3112,651,62,235,525,1473
u,m,1895,6176,155605,21802,1829,6437,4743,34811
m,m,1897,8959,1137436,216071,16479,50136,118668,401354
u,f,1845,1296,42577,3082,285,1255,857,5479
m,f,1847,1249,154275,21710,1807,6707,16559,46783
m,u,1745,0,0,0,0,0,0,0
m,m,2007,20398,1223483,636475,41246,105852,287985,1071558
f,f,1739,36,291,406,61,282,507,1256
f,m,1945,3764,359433,136081,10289,24544,66906,237820
m,m,1994,19377,1328453,587882,37844,99321,264204,989251
f,m,1821,221,24698,3442,302,1175,3176,8095
f,f,1872,1791,375071,60631,5781,15347,45144,126903
m,f,1747,0,0,0,0,0,0,0
u,m,1953,8306,172124,45586,3089,9360,8784,66819
m,m,1816,368,26379,4959,461,1593,4470,11483
f,f,1757,0,0,0,0,0,0,0
m,u,1909,2752,279896,59988,4383,14667,31613,110651
f,u,1919,1126,165441,36278,2913,8238,21317,68746
m,u,1739,0,0,0,0,0,0,0
m,m,1770,27,2849,354,22,153,219,748
f,u,1876,322,68523,11456,1016,3060,8863,24395
f,u,1864,449,72127,11189,1030,2594,8257,23070
f,m,1782,33,0,204,14,65,138,421
m,f,1981,6460,463151,205026,14980,38174,92059,350239
f,f,1891,2449,589318,106827,9422,23890,73772,213911
m,m,1934,12459,1266641,445543,32709,85655,218681,782588
u,f,2005,5769,103778,34109,2363,6427,7699,50598
m,u,1852,407,74610,10483,904,3022,7022,21431
u,f,1942,2003,37066,10236,837,2497,2351,15921
f,m,1994,6152,445086,207768,13584,35842,108682,365876
u,m,1984,11115,157481,76047,4095,13754,17014,110910
m,f,1735,0,0,0,0,0,0,0
f,f,1825,287,101243,13250,955,4120,10201,28526
m,u,1806,2,324,8,0,2,3,13
m,u,1947,21446,1849274,648577,47412,118733,309939,1124661
f,f,1882,1753,381751,73109,6603,17818,51134,148664
m,f,1759,33,4849,345,20,154,230,749
u,f,1757,0,0,0,0,0,0,0
m,m,1789,87,6682,1454,132,539,949,3074
m,m,1912,11909,1650518,352321,25938,76036,176796,631091
m,u,1983,37003,1978028,780076,55874,151564,379731,1367245
u,f,1705,0,0,0,0,0,0,0
f,m,1986,5471,415256,203494,12972,33994,103896,354356
f,u,1762,0,0,0,0,0,0,0
u,u,1716,0,0,0,0,0,0,0
f,f,1934,2736,375463,144023,11173,25847,80823,261866
f,f,1845,1226,213734,31464,3130,10558,35594,80746
u,m,1963,9418,139613,47579,3188,9535,9247,69549
u,f,1727,58,259,152,27,45,22,246
f,f,1967,2327,203110,95108,7122,16895,49444,168569
u,u,1847,91,2086,281,27,102,60,470
u,u,1806,0,0,0,0,0,0,0
u,u,1812,44,2063,120,16,50,40,226
u,f,1892,2049,70217,8477,781,2483,2187,13928
u,u,1852,197,4564,584,41,164,64,853
m,m,1755,99,1689,810,71,328,709,1918
f,m,1947,5999,586910,214278,16133,38687,108485,377583
m,u,1914,3716,425890,80082,6350,19913,41199,147544
f,m,1799,59,2339,906,66,316,730,2018
u,u,2008,12064,167654,66272,4612,12982,14056,97922
f,f,1962,2249,266555,106282,7754,18026,53465,185527
u,f,2012,0,0,0,0,0,0,0
m,f,1905,2833,369327,76925,5715,16438,41681,140759
u,m,1976,9258,143042,42994,2758,8712,8605,63069
m,m,1833,2252,304036,32796,2677,9686,25857,71016
u,u,1777,0,0,0,0,0,0,0
u,f,1992,5348,122556,38171,2329,7171,9823,57494
f,f,1885,1897,405658,82958,7493,20504,59609,170564
f,f,1853,1186,310413,43768,3817,11636,34890,94111
f,f,2006,6444,730336,389139,24631,60855,214403,689028
u,f,1712,0,0,0,0,0,0,0
f,f,1976,2990,304659,132368,10292,23861,69625,236146
m,u,1913,3991,446877,87274,6389,21860,41867,157390
m,f,1858,1752,283221,47666,3882,12317,31463,95328
f,u,1808,139,17309,2072,216,822,1485,4595
u,f,1810,455,10556,1644,82,576,431,2733
u,f,1870,987,29618,3188,295,941,901,5325
u,m,1783,11,8,12,1,6,3,22
f,u,1996,14189,922248,416693,31654,78724,237187,764258
f,u,1736,0,0,0,0,0,0,0
m,m,1843,1874,295467,38015,2761,11080,27867,79723
f,f,1822,452,89950,14879,1283,4940,13811,34913
u,m,1737,0,0,0,0,0,0,0
u,u,1995,21819,368827,113461,8063,24103,26297,171924
u,m,1995,10557,200273,60910,3824,11340,12922,88996
f,u,1874,173,29973,4754,411,1344,3960,10469
m,f,1728,0,0,0,0,0,0,0
f,m,1847,589,124189,19169,1517,5905,15419,42010
m,f,1918,4221,515231,122467,9171,25175,58951,215764
m,u,1859,543,38893,9331,821,2387,5862,18401
m,m,1739,78,1149,939,74,390,435,1838
f,f,1975,2872,281402,124644,9175,22037,65630,221486
f,u,1748,6,0,104,11,61,156,332
u,m,1874,1711,62930,6197,579,1926,1380,10082
f,f,1726,0,0,0,0,0,0,0
f,u,1773,0,0,0,0,0,0,0
u,m,1901,3842,113938,15488,1104,4538,3083,24213
f,u,1930,6571,721583,246136,19076,51547,141199,457958
u,u,1890,412,10869,1439,153,372,304,2268
u,u,1817,55,960,158,25,72,52,307
m,m,1776,0,0,0,0,0,0,0
u,u,1934,8321,224721,37729,2890,9852,8158,58629
f,m,1811,223,17788,5483,456,1945,5831,13715
m,u,1765,36,1396,730,72,205,637,1644
u,u,1952,12946,342394,76611,5157,16583,15454,113805
f,f,1969,2588,293190,131637,9472,22381,63987,227477
m,f,1976,5646,417584,171096,12895,31082,73164,288237
u,u,1993,25926,396649,136256,9792,27862,31427,205337
f,f,1710,0,0,0,0,0,0,0
u,f,1918,1844,38096,6823,567,1710,1591,10691
m,m,1825,2726,373251,45717,3560,13824,37298,100399
m,m,1882,5931,609504,121759,11311,30833,75941,239844
f,f,1830,417,83010,13519,1131,3969,14066,32685
f,m,1997,7582,656184,283574,18307,49281,146821,497983
f,u,1766,0,0,0,0,0,0,0
m,f,1919,4813,680123,152728,11906,32680,76826,274140
m,f,1731,0,0,0,0,0,0,0
m,m,1845,2331,351800,45207,3592,13528,32425,94752
u,f,1974,2808,49826,17471,1209,3220,4196,26096
m,u,1780,49,2088,346,45,159,372,922
f,m,1768,31,851,125,18,57,147,347
u,m,1743,0,0,0,0,0,0,0
m,m,1967,20820,1643322,696085,45700,120635,307595,1170015
f,f,1978,2724,290749,147370,10431,23870,77476,259147
f,m,1859,1574,233059,31765,2879,9172,26912,70728
u,m,1985,9358,195367,55524,3230,9845,11614,80213
f,m,1877,1392,264510,40092,3743,10805,29416,84056
m,f,1810,648,92398,19217,1220,6468,16549,43454
u,f,2010,12,0,67,3,12,6,88
f,f,2011,0,0,0,0,0,0,0
m,u,1963,24584,1610460,650753,46854,127243,325477,1150327
m,m,1941,10336,983938,335831,22646,59820,155034,573331
m,f,1920,5402,704240,156775,12800,34222,78872,282669
u,m,1756,6,0,7,0,5,1,13
m,m,1844,4451,817965,97356,6762,31352,67951,203421
m,u,2003,25943,1407342,593805,41644,112526,292982,1040957
m,u,1846,396,31001,3342,302,1132,2626,7402
u,f,1994,5968,147230,47547,2700,8026,11338,69611
u,f,1865,1202,41646,4197,417,1309,1118,7041
u,m,1765,0,0,0,0,0,0,0
f,m,1954,5646,581400,217878,15909,39066,109653,382506
u,f,1707,0,0,0,0,0,0,0
m,m,1764,113,1916,475,34,202,413,1124
f,u,1754,0,0,0,0,0,0,0
m,u,1763,0,0,0,0,0,0,0
m,m,1954,18101,1603849,597277,39604,99953,258036,994870
f,u,1775,0,0,0,0,0,0,0
u,u,1943,9346,160104,41249,2753,9033,7857,60892
f,u,1772,0,0,0,0,0,0,0
u,m,1735,33,869,19,1,14,3,37
u,m,1897,4825,161826,19770,1483,5695,4275,31223
m,f,1987,7697,525492,237202,16878,43038,110592,407710
u,f,1972,2009,38898,9578,728,2038,1938,14282
u,u,1957,13898,331968,80131,5646,17225,15947,118949
u,m,1812,1240,29983,6137,484,2152,1074,9847
m,u,1793,42,1158,418,44,158,522,1142
m,u,1766,0,0,0,0,0,0,0
f,f,1863,1161,341848,58435,5009,14771,42274,120489
f,u,1847,65,6248,1017,85,385,1024,2511
f,m,1816,65,11422,1511,116,516,1631,3774
u,f,1850,529,17451,1648,163,540,397,2748
u,f,2002,5416,78918,27674,1917,5742,6553,41886
f,f,1843,437,95540,12924,1108,4207,11931,30170
m,f,1727,13,0,272,13,94,161,540
u,m,1879,1135,32259,3411,319,1030,750,5510
m,u,1940,11135,934314,324249,22469,59600,151684,558002
u,m,1886,2629,69687,9101,738,2739,2030,14608
f,m,1820,183,15485,3313,277,1040,3078,7708
u,u,1986,20511,386341,112495,7640,22524,23241,165900
m,m,1719,11,643,39,2,16,27,84
f,f,1856,1517,392609,59601,5256,15334,48923,129114
u,f,1898,2093,70140,7783,687,1983,1850,12303
m,f,2011,0,0,0,0,0,0,0
m,u,1798,0,0,0,0,0,0,0
m,f,1881,3109,344541,80838,7173,20226,45480,153717
m,u,1848,317,38865,5311,452,1619,4203,11585
f,u,1742,0,0,0,0,0,0,0
m,u,1919,3387,348099,85908,6345,18128,40614,150995
m,f,1903,3155,372098,80901,6572,17847,44567,149887
f,u,1872,462,76318,13188,1293,3520,10046,28047
m,m,1726,73,811,157,12,45,153,367
m,u,1748,9,920,339,23,97,311,770
m,f,1964,4564,326909,145671,10724,26243,62639,245277
f,m,1888,2361,444222,79126,6688,20348,56906,163068
m,u,1938,12505,855606,335564,24707,64558,168231,593060
f,m,1832,412,95515,12496,1069,4146,10979,28690
u,m,1761,14,40,147,19,49,34,249
m,m,1869,3983,395809,67582,6409,18726,43724,136441
m,u,1875,433,31829,7589,669,2045,4155,14458
u,f,1973,2583,36942,13786,1046,2896,3399,21127
m,m,1793,58,5193,1382,161,498,834,2875
m,m,1805,95,8796,1426,111,509,1212,3258
u,u,1732,7,0,15,2,9,2,28
m,f,1811,169,8219,3471,242,1124,2989,7826
u,u,1814,27,107,17,1,9,1,28
u,m,1814,30,1026,175,16,59,36,286
m,m,1969,24600,1695716,712310,47595,121615,311867,1193387
u,u,1740,0,0,0,0,0,0,0
m,m,1710,0,0,0,0,0,0,0
f,m,1767,16,0,96,9,28,54,187
u,m,1792,43,1860,98,11,31,15,155
m,m,1780,72,3603,633,50,170,624,1477
u,u,2011,65,485,63,2,16,3,84
u,u,1807,49,591,113,15,43,25,196
m,f,1800,245,18337,4947,503,1450,3370,10270
f,u,1927,4589,377371,148322,11927,32579,88391,281219
u,f,1876,1281,51878,5858,586,1556,1736,9736
m,m,1894,11423,1541507,273570,20843,67013,153674,515100
m,f,1943,4519,389171,143272,10604,26262,64337,244475
f,u,2005,11978,751477,393091,28027,71406,219776,712300
f,f,1760,0,0,0,0,0,0,0
m,f,1768,0,0,0,0,0,0,0
f,m,1939,2865,289044,104159,7905,19573,55510,187147
u,u,1743,0,0,0,0,0,0,0
f,u,1942,3758,387716,140303,10404,26128,74318,251153
m,m,1827,1256,177427,21711,1989,6830,18137,48667
u,u,1866,111,2101,261,25,99,72,457
m,f,1839,970,115153,16948,1370,4894,13571,36783
m,u,1973,25512,1242002,577189,43361,115015,285756,1021321
m,f,1826,612,79425,12186,969,3702,10300,27157
f,m,1810,236,7992,6343,711,2261,5775,15090
u,f,1924,1656,31124,8003,638,1891,1900,12432
m,f,1946,6726,671413,212745,14723,37217,94401,359086
u,u,1789,24,0,37,11,22,10,80
m,f,1947,5836,517508,187665,13969,33235,85082,319951
f,u,1705,0,0,0,0,0,0,0
m,f,1836,1074,168288,24144,2089,7358,17473,51064
m,u,1832,1040,93053,11783,1031,3417,11463,27694
m,m,1888,7238,1028203,177949,14027,44313,104760,341049
f,u,1732,2,0,26,2,10,33,71
f,u,1940,3671,405926,144731,10465,26084,73622,254902
f,u,1939,3379,335457,114501,8248,22001,62110,206860
m,f,1708,0,0,0,0,0,0,0
f,f,1764,0,0,0,0,0,0,0
u,m,1808,308,9857,1328,115,497,484,2424
f,m,1773,14,645,227,24,131,368,750
f,u,1783,0,0,0,0,0,0,0
f,m,1823,534,74469,10238,1016,3360,10214,24828
u,u,1941,7341,125694,34151,2423,8336,8057,52967
m,u,1771,0,0,0,0,0,0,0
m,u,1873,614,77539,13872,1247,3565,8229,26913
f,f,1782,0,0,0,0,0,0,0
m,f,1952,6001,511654,199946,14960,37096,93727,345729
u,m,1736,680,10601,1412,164,686,351,2613
u,m,1796,281,2956,478,48,201,180,907
u,u,1972,17302,266205,75867,5619,16474,16343,114303
m,f,1853,1602,253331,38261,3676,10170,26082,78189
f,f,1937,2870,429044,167269,11914,27597,86992,293772
m,u,1741,16,4068,498,39,169,444,1150
m,u,1719,0,0,0,0,0,0,0
m,m,1735,16,0,40,5,11,22,78
u,u,1765,13,90,10,0,6,3,19
u,f,1902,1111,36068,5769,468,1371,1318,8926
m,f,2009,6280,235689,213100,14912,39841,100105,367958
m,m,1759,35,822,550,36,214,340,1140
f,m,1727,41,1844,366,43,260,602,1271
f,u,1896,368,75515,13984,1206,3170,7976,26336
m,f,1970,6921,452741,183892,13829,34030,79231,310982
f,u,2013,0,0,0,0,0,0,0
f,f,1777,0,0,0,0,0,0,0
f,f,1908,2556,582302,109696,8681,22648,68068,209093
f,m,1843,470,67277,8596,706,2872,7582,19756
u,f,1933,1649,31151,8858,647,1797,2050,13352
f,u,1752,13,0,137,15,56,118,326
m,f,1733,0,0,0,0,0,0,0
u,m,1777,17,0,31,2,5,1,39
m,u,1860,1071,150923,23339,2057,6267,16576,48239
f,f,2007,6584,641696,369014,24336,60318,205692,659360
f,u,1819,96,9259,2868,211,995,2482,6556
u,m,1916,4175,121237,17654,1361,4644,4354,28013
m,u,1954,17970,1437876,541266,37596,101064,264097,944023
f,m,1747,0,0,0,0,0,0,0
u,f,1753,19,1547,156,16,50,48,270
m,u,1880,574,70668,12138,1040,3325,7227,23730
f,u,1977,10925,875396,365712,27085,69654,197126,659577
u,u,1719,0,0,0,0,0,0,0
f,u,1725,4,0,76,3,51,86,216
u,m,1748,30,0,60,5,12,4,81
f,f,1982,3454,454148,212180,13641,33154,107720,366695
m,f,1829,902,139395,15839,1440,4975,12801,35055
m,f,1796,107,1701,974,88,368,746,2176
m,u,1883,479,49418,7886,803,2121,4992,15802
m,m,1724,0,0,0,0,0,0,0
m,u,1937,14105,1108002,374525,27142,72605,184359,658631
u,f,1731,0,0,0,0,0,0,0
m,m,1987,18408,1331420,602449,38063,100599,263160,1004271
u,m,1809,223,3387,425,36,156,81,698
u,m,1770,24,1847,44,3,9,8,64
m,u,1920,7042,754310,185371,14813,41101,94063,335348
f,m,1825,759,119329,15358,1306,5132,15089,36885
u,m,1817,219,6069,723,74,293,177,1267
f,m,1841,673,130045,15689,1300,5856,13469,36314
f,m,1800,85,17294,2222,150,806,1846,5024
f,f,1815,315,95989,13410,1093,4171,11865,30539
m,u,1984,29528,1443303,658392,47775,123463,317448,1147078
m,f,1986,6217,403470,183430,13237,33565,82050,312282
u,u,1953,12827,278977,67992,4599,14961,14123,101675
m,m,1792,105,7562,1554,124,525,966,3169
u,f,1907,2050,55868,8341,686,2281,1916,13224
m,m,1760,16,21,33,4,28,44,109
f,u,2007,13113,840140,438380,28992,74972,238571,780915
u,u,1830,705,33920,2301,195,889,538,3923
f,m,1921,3938,647181,158429,12456,34298,92877,298060
f,m,1839,580,88270,12607,915,4002,11259,28783
f,m,1978,6291,521955,228587,15432,40279,110802,395100
f,f,1877,1562,301896,60038,5750,15115,46319,127222
u,f,1871,1040,35722,3833,363,1068,868,6132
u,u,1856,196,6135,321,30,125,84,560
m,f,1879,2117,287902,59879,5535,14040,34281,113735
u,m,1775,0,0,0,0,0,0,0
u,f,1735,0,0,0,0,0,0,0
u,m,1794,7,0,6,0,0,5,11
m,m,1812,439,54309,8040,526,2703,5874,17143
m,m,1746,0,0,0,0,0,0,0
u,f,1894,2074,66565,7817,671,2299,2244,13031
f,u,1710,0,0,0,0,0,0,0
m,f,1855,2170,318550,48625,3782,12893,31411,96711
m,u,1807,85,8505,2070,201,689,1719,4679
m,m,1880,6040,908871,139654,11195,37706,88112,276667
u,m,1888,4307,148930,15229,1284,4459,3379,24351
u,u,1917,1962,65687,10081,755,2443,2023,15302
u,f,1906,1983,61818,8894,725,2159,2222,14000
f,u,2008,7700,471965,264597,19419,49817,145453,479286
f,u,2010,659,40616,15917,1208,2909,8577,28611
m,u,2007,33229,1788212,849907,57287,153770,408294,1469258
u,f,1841,766,26869,1979,194,748,518,3439
m,f,1776,0,0,0,0,0,0,0
u,f,1877,1421,54117,6943,561,1868,1929,11301
f,u,1970,12938,1087736,411155,31054,81826,235044,759079
m,m,1976,17544,1281634,545915,34275,92431,250991,923612
f,m,1853,1470,121902,17071,1615,5347,13637,37670
m,m,1937,14705,1222791,455515,32922,83143,213599,785179
f,m,1909,2900,459325,95847,7463,22283,57798,183391
f,u,1966,9227,784205,312414,23261,59143,173504,568322
f,u,1885,162,17855,2609,287,710,2080,5686
f,f,1709,0,0,0,0,0,0,0
m,m,1727,106,6440,1054,102,450,816,2422
u,f,1824,301,13949,1082,88,431,177,1778
u,m,1872,3537,81019,7470,751,2421,1750,12392
m,f,1783,0,0,0,0,0,0,0
f,m,1918,2895,404754,98766,7771,20648,56449,183634
f,m,1733,2,0,1,0,0,0,1
f,u,1704,0,0,0,0,0,0,0
u,f,2004,5390,100801,35397,2505,6373,7991,52266
u,f,1797,87,3573,691,59,207,144,1101
f,u,1833,87,10656,2020,174,704,2116,5014
m,f,1961,4655,368504,153298,11367,27367,70333,262365
f,u,1741,17,1909,302,17,100,397,816
m,u,1777,0,0,0,0,0,0,0
u,u,1727,0,0,0,0,0,0,0
f,u,1786,0,0,0,0,0,0,0
m,m,1877,4462,709847,100133,8683,26431,64304,199551
m,u,2008,18845,887209,468960,33750,89994,225992,818696
u,u,1935,7896,167415,41279,3054,8820,9038,62191
u,f,1979,3735,88934,31272,1695,5643,7439,46049
f,f,1776,0,0,0,0,0,0,0
u,f,1742,0,0,0,0,0,0,0
f,m,1796,143,13381,2458,224,1038,3315,7035
f,m,1998,6688,477918,236864,15651,41666,132210,426391
f,m,1741,51,45,1923,154,619,1368,4064
m,u,1711,0,0,0,0,0,0,0
u,u,1786,0,0,0,0,0,0,0
m,u,1838,257,22463,3071,228,983,2447,6729
u,u,1959,15002,311292,76087,4983,16783,15471,113324
m,u,1760,25,221,308,36,132,321,797
m,f,1825,433,74095,11351,919,3236,7577,23083
m,u,1809,51,2053,843,83,296,672,1894
f,f,1809,295,57536,9582,919,3274,8879,22654
f,u,1973,8548,498463,259335,20826,51491,143886,475538
f,u,1855,602,126096,20903,1856,6059,17173,45991
f,m,1948,4673,481273,181922,13463,33159,94523,323067
m,u,1756,0,0,0,0,0,0,0
m,m,1978,20638,1574592,670160,42558,110751,292836,1116305
m,f,1859,1347,191343,30937,2827,8419,21968,64151
f,m,1822,239,19170,4443,394,1369,4130,10336
u,m,1936,5589,80335,23732,1865,5659,5645,36901
m,u,1927,14111,821262,287666,22940,64251,157295,532152
m,u,1959,21066,1387921,490150,35554,99255,249114,874073
u,u,1928,11427,189599,48351,3494,12749,9524,74118
u,m,1934,6739,200902,39713,2687,8742,8400,59542
m,m,1715,33,407,222,16,52,170,460
m,m,2011,85,6866,2098,62,266,1015,3441
m,m,1839,2043,310326,38200,2649,11697,28324,80870
u,u,1921,2234,42889,8549,690,2169,1739,13147
m,m,1826,1942,345521,38874,2767,11286,31942,84869
f,m,1988,6331,487014,230088,14655,39648,123102,407493
f,m,1920,4111,658129,165351,13309,34647,94750,308057
m,m,1785,79,7879,2123,181,840,1636,4780
f,u,1989,14327,848782,431432,30927,78869,238915,780143
f,m,1808,151,13069,2998,290,1179,3765,8232
f,f,1746,0,0,0,0,0,0,0
u,f,1911,2320,73701,12153,961,2911,2921,18946
m,u,1842,207,25510,2881,262,837,2401,6381
u,u,1726,0,0,0,0,0,0,0
f,f,1954,3037,401181,160827,11113,28078,84738,284756
f,u,1881,263,33383,5835,596,1549,4029,12009
f,u,1924,4191,413320,143809,11820,30691,86491,272811
f,u,1792,0,0,0,0,0,0,0
u,m,1731,0,0,0,0,0,0,0
u,m,1767,19,7,63,4,27,7,101
f,m,1987,5924,421409,199031,13603,34710,101860,349204
u,m,1722,55,366,47,3,33,0,83
f,u,1986,12209,871257,397792,28259,74155,218754,718960
m,u,1879,1205,199267,33934,3058,8785,20899,66676
u,f,1825,147,2856,381,38,147,84,650
u,f,1732,0,0,0,0,0,0,0
u,m,1841,1081,39828,3083,220,1205,662,5170
m,u,1982,31104,1807830,720259,52801,138291,348856,1260207
m,f,1909,4715,613160,120446,9656,27008,62247,219357
u,u,1733,0,0,0,0,0,0,0
m,m,1863,2489,325438,50850,4490,14213,33550,103103
f,f,1875,2194,430754,87659,7884,21278,66907,183728
m,m,2009,12600,688900,430156,26479,71544,189247,717426
m,m,1990,21205,1394577,619373,40096,106694,284690,1050853
f,f,1841,1075,176169,31855,3001,10462,28920,74238
f,m,1766,10,0,27,5,15,48,95
u,m,1802,14,714,38,6,15,3,62
f,u,1796,2,0,3,0,0,4,7
f,f,1727,8,2195,127,7,83,148,365
f,f,1719,20,0,197,25,199,364,785
m,m,1856,3692,455852,68083,5544,19203,43710,136540
u,u,1880,227,4659,554,53,166,150,923
m,u,1960,23764,1881958,714165,47968,135846,355183,1253162
f,u,1917,1253,178668,40526,3287,9670,25064,78547
m,f,1977,4650,293546,134374,10140,25180,61457,231151
u,m,1896,7929,286528,29816,2364,8819,6027,47026
m,f,1771,18,729,35,3,16,48,102
u,f,1761,0,0,0,0,0,0,0
f,m,1965,5947,464899,185811,12750,33494,94374,326429
f,m,1961,6324,541580,224752,16359,41953,112351,395415
f,m,1903,2148,326817,64526,4753,15282,41885,126446
m,m,1965,20195,1523733,601475,39142,103513,278140,1022270
m,m,1878,5793,617741,108857,9693,29178,69541,217269
f,f,1911,2837,632836,122910,9446,25951,75126,233433
m,f,1888,3381,399679,83586,7811,20811,48570,160778
f,u,1739,0,0,0,0,0,0,0
f,f,1793,49,6871,1204,100,547,1493,3344
f,u,1763,0,0,0,0,0,0,0
f,m,1982,5677,478746,209740,13648,36556,103354,363298
f,u,1948,7381,676749,263971,21359,52705,147281,485316
u,f,1995,5608,86640,28634,1988,6042,7062,43726
m,f,1767,0,0,0,0,0,0,0
u,m,1793,32,0,26,3,8,7,44
f,m,1917,2897,461443,107573,8465,23077,63434,202549
f,f,1780,0,0,0,0,0,0,0
u,f,1977,2535,56238,18802,1219,3308,3802,27131
u,u,1815,123,5449,680,59,271,314,1324
m,u,1901,2995,361250,69757,5616,16614,37233,129220
m,u,1764,0,0,0,0,0,0,0
m,u,1994,37034,1913545,863123,63581,164873,417931,1509508
u,f,1929,2504,57356,16377,1372,3287,3239,24275
u,m,1892,5215,168104,18047,1512,5588,3571,28718
f,f,1834,726,202689,27847,2306,7993,23757,61903
u,m,1962,8360,136711,42699,2674,8333,7767,61473
u,f,1940,1578,47663,9854,657,2087,1999,14597
m,u,1942,13228,1035485,348909,24625,63493,160616,597643
m,f,1939,3862,371529,130771,9300,24356,62402,226829
m,u,1933,13530,1122038,373609,27892,76682,187118,665301
m,f,1803,172,15090,3980,312,1379,3335,9006
f,f,1892,2977,648718,129699,12180,30039,90289,262207
f,f,1827,789,191456,29580,2237,9723,23956,65496
f,f,1767,0,0,0,0,0,0,0
f,m,1826,489,93092,10641,800,3268,10460,25169
f,f,1715,0,0,0,0,0,0,0
f,f,1839,590,108384,17464,1509,5063,16527,40563
f,f,1861,840,142632,23671,2350,6405,18694,51120
f,m,1946,5253,531671,195517,14190,34786,98160,342653
m,f,1988,9566,770918,310104,21408,55724,145952,533188
u,m,1992,9171,121028,41413,2942,8493,9253,62101
u,m,2006,10989,134846,53954,3395,10576,11819,79744
u,u,2006,20214,363576,128671,8461,24548,29158,190838
u,m,1772,66,482,46,9,20,13,88
f,m,1817,131,15917,2697,234,854,2115,5900
u,m,1923,6190,120110,30004,2223,7335,6632,46194
f,f,1774,12,111,118,11,69,124,322
u,m,1810,342,6050,785,82,264,219,1350
f,f,1737,0,0,0,0,0,0,0
u,f,1905,1246,36646,5502,382,1368,1215,8467
u,f,1853,517,21272,1712,181,580,361,2834
f,u,1768,0,0,0,0,0,0,0
u,m,1968,12675,189480,64968,4129,13043,12837,94977
m,u,1828,349,32670,4594,474,1367,3004,9439
f,f,1889,2555,599669,111655,10384,25743,77515,225297
f,f,1995,5880,641707,316320,20226,51364,165999,553909
m,u,1781,11,203,116,11,47,105,279
m,f,1791,134,20159,4005,316,1292,2708,8321
u,m,2010,83,257,360,29,41,47,477
m,m,1875,2844,429864,74354,6399,18884,44568,144205
u,m,1975,9251,155574,46632,2891,8928,9107,67558
m,u,1768,5,163,41,3,25,80,149
f,m,1778,0,0,0,0,0,0,0
f,u,1906,867,147613,27830,2196,6690,16238,52954
m,u,1726,0,0,0,0,0,0,0
m,m,1908,8643,1322101,275844,19506,58460,142654,496464
m,u,1874,393,49669,8199,701,2185,5404,16489
u,m,1863,1238,38483,3522,344,1311,805,5982
m,f,1928,4111,346390,129080,10322,26143,63662,229207
u,u,1762,0,0,0,0,0,0,0
u,u,1951,11190,224962,59078,4169,12654,11830,87731
m,u,1936,16359,1097444,366888,28552,71521,195052,662013
u,m,2009,7059,105344,42362,2613,7660,8453,61088
f,f,1886,2521,493279,98580,8956,22658,71708,201902
m,m,1802,19,1725,460,26,133,483,1102
m,m,1837,2255,411025,50456,4033,14820,37612,106921
u,u,1896,466,10296,1465,104,379,327,2275
u,f,1966,2278,38347,14229,1006,2859,3132,21226
u,f,1885,1384,38542,5925,577,1700,1569,9771
u,m,1853,2124,48311,5886,476,1990,1527,9879
u,m,1804,362,9317,737,89,291,134,1251
u,m,1972,8671,146831,45738,3009,8806,9604,67157
u,f,1774,23,0,16,0,4,5,25
u,m,1918,4494,121953,19407,1471,4706,3888,29472
u,u,1876,346,10950,1170,127,387,330,2014
m,u,1899,1165,131183,24405,1935,5724,14069,46133
u,m,1925,6050,128974,29570,2176,6663,6487,44896
u,u,1925,9217,214144,43310,3228,11367,8702,66607
m,m,1779,0,0,0,0,0,0,0
m,u,1772,0,0,0,0,0,0,0
m,m,1758,0,0,0,0,0,0,0
m,m,1982,19214,1604162,627108,39631,105117,277151,1049007
f,m,1829,1055,190818,19902,1546,5811,19876,47135
f,f,1730,0,0,0,0,0,0,0
u,m,1815,232,2948,223,34,88,67,412
m,u,1853,587,69493,11109,984,3218,7505,22816
u,f,1744,0,0,0,0,0,0,0
f,u,1886,355,52249,10493,1095,2735,8755,23078
f,f,1987,4415,507808,253834,17519,41684,136835,449872
m,f,1917,4593,679159,147872,11388,30869,73421,263550
u,m,1887,3581,116241,15234,1255,3929,3192,23610
u,m,1718,0,0,0,0,0,0,0
m,f,1841,1761,216692,36488,3104,11038,26975,77605
m,f,1863,1846,303935,54281,4726,14304,33251,106562
m,m,1834,2720,494168,46523,3458,13722,37627,101330
f,f,1792,46,3661,1705,136,616,2271,4728
m,u,1886,749,72903,12232,1225,3322,8366,25145
m,f,1785,82,834,636,51,218,545,1450
f,m,1893,3078,501886,89948,7702,23789,59268,180707
m,f,1732,0,0,0,0,0,0,0
m,u,1710,0,0,0,0,0,0,0
m,u,1996,35186,1778526,742602,55413,148114,365114,1311243
f,m,1732,0,0,0,0,0,0,0
m,f,1978,5291,399222,175477,12935,32019,84819,305250
u,f,1943,2049,54971,12725,784,2717,2929,19155
m,m,1768,54,743,378,69,125,275,847
m,f,1817,597,104724,19015,1319,5283,16082,41699
m,f,1726,0,0,0,0,0,0,0
u,f,1792,50,2779,217,21,79,47,364
f,u,1799,0,0,0,0,0,0,0
u,m,1986,9366,142803,47687,3010,8906,9467,69070
f,m,1911,3835,688042,137113,10629,30086,81439,259267
u,m,1843,822,24990,2060,184,718,353,3315
f,f,1880,1843,361451,90257,7926,21940,67917,188040
m,m,1794,15,406,51,7,29,58,145
u,m,1850,1938,73241,5790,486,2058,1344,9678
u,m,1989,11104,158394,52671,3411,10019,10612,76713
m,f,1915,5427,760265,157425,12368,35910,81064,286767
f,u,1935,4814,506472,189779,14868,36486,112976,354109
m,f,1805,75,9695,2420,161,759,2077,5417
u,f,1987,3948,90000,26096,1577,4823,6189,38685
u,m,1950,9204,234856,56275,3134,10595,11009,81013
u,f,1764,0,0,0,0,0,0,0
f,f,1850,806,264594,39052,3374,10915,31702,85043
u,f,1889,2106,80991,9063,817,2674,2234,14788
u,f,1857,736,17206,2166,221,726,513,3626
f,m,1932,4104,413157,165137,13243,32688,89838,300906
m,m,1729,0,0,0,0,0,0,0
u,m,1924,6118,101554,23070,1722,5570,5428,35790
u,f,1788,0,0,0,0,0,0,0
f,u,1859,293,34259,7911,672,2069,6441,17093
f,u,2012,0,0,0,0,0,0,0
f,u,1895,346,50618,10891,932,2603,8570,22996
u,u,1799,0,0,0,0,0,0,0
m,f,1778,0,0,0,0,0,0,0
u,u,1742,0,0,0,0,0,0,0
m,u,1868,1049,149271,28350,2093,7280,16033,53756
m,u,1975,29234,1667984,663693,50160,132773,328834,1175460
f,m,1928,4271,455278,155582,12524,32905,87994,289005
m,m,1712,0,0,0,0,0,0,0
u,f,1957,2437,50854,17130,1283,3444,3385,25242
f,m,1783,2,31,8,2,1,13,24
f,f,1867,1748,398230,71855,6985,17381,52904,149125
m,m,1876,4540,723542,114080,9710,30205,72789,226784
m,f,1930,3975,354801,130300,10019,27081,62212,229612
u,f,1964,2592,36122,15145,1173,2971,3535,22824
f,f,1837,413,92468,13979,1223,4129,13377,32708
f,m,1980,5812,495613,203065,13851,35293,99490,351699
u,u,1840,174,5420,498,53,150,87,788
f,m,1979,5620,474794,195958,13706,34616,103999,348279
f,m,1876,1482,292431,50975,4362,13532,40115,108984
m,u,1712,0,0,0,0,0,0,0
u,m,1837,1139,49394,3694,303,1323,758,6078
m,u,1816,196,14770,2674,233,910,2230,6047
u,m,1751,148,5167,212,22,134,40,408
