chargender,authgender,date,characters,speaking,agent,mod,patient,poss,total
f,m,1919,3484,607392,138732,10988,29150,79529,258399
m,u,1994,31530,1738040,774261,55982,146659,381423,1358325
f,m,1941,3465,321513,127272,9418,24057,68158,228905
f,u,1843,106,29208,3386,292,1144,3314,8136
u,m,1922,6877,165559,28809,2212,7120,6134,44275
u,m,1931,5696,131359,28639,2074,6760,6062,43535
u,u,1862,175,4217,328,39,107,99,573
m,u,1812,93,11828,1978,191,643,1794,4606
f,m,1827,460,56630,7985,836,2897,8129,19847
f,f,1897,2349,491804,95070,8298,20772,66012,190152
u,u,1980,16341,307474,91189,6011,18055,18711,133966
m,f,1996,15237,1039346,438179,29947,78477,191662,738265
u,u,1977,18486,298560,90807,7054,19675,19386,136922
f,m,1822,239,19170,4443,394,1369,4130,10336
m,f,1810,648,92398,19217,1220,6468,16549,43454
u,m,1967,12082,195338,60916,3951,12219,12571,89657
m,u,1875,433,31829,7589,669,2045,4155,14458
f,m,1954,5831,592159,222037,16138,39756,110826,388757
m,u,2011,31,1795,34,8,23,0,65
f,f,1878,1576,350516,69070,6337,15911,50835,142153
m,m,2014,0,0,0,0,0,0,0
f,u,1866,227,50826,7335,680,1919,5163,15097
m,f,1856,2306,363895,54660,5151,14338,37665,111814
m,f,1990,11046,628777,299240,21483,56009,136880,513612
f,f,1950,3198,431024,175548,12037,28738,86014,302337
f,m,1962,6118,538397,199595,14406,36301,97427,347729
f,m,1922,5360,855916,205889,15906,42429,117766,381990
u,f,1934,2580,36489,10950,985,2717,2529,17181
m,u,1950,20158,1972113,651600,46673,134838,336444,1169555
u,m,1963,10419,149985,51240,3525,10333,9896,74994
f,m,1879,898,174898,34359,2951,8689,23245,69244
f,u,1998,9936,658376,317342,23030,59307,186359,586038
m,u,1869,346,40046,8782,779,2191,6350,18102
f,m,1804,192,15955,3356,289,1093,2979,7717
m,m,1870,3804,625164,95628,7689,26529,60311,190157
u,f,1985,5006,97627,30233,2010,6028,7079,45350
u,f,1967,3234,61344,18836,1275,3581,3462,27154
u,f,1959,2761,78390,20975,1330,3746,4209,30260
u,u,1860,495,36018,2661,240,866,526,4293
m,u,1896,991,116864,20018,1626,4843,10314,36801
u,m,1935,9066,187718,51286,3657,10761,10727,76431
u,m,2003,12460,159887,59261,4013,12393,12946,88613
f,m,1928,4470,462999,161336,12850,34089,90890,299165
m,m,1836,2343,282681,31170,2516,9321,25098,68105
m,m,1908,9065,1377651,286015,20271,61182,147885,515353
u,u,1811,109,8015,581,41,199,89,910
f,m,1868,1133,153679,27827,2607,8313,21256,60003
u,u,2002,16912,280162,85378,5936,16454,20131,127899
f,u,1914,680,121066,22465,1739,5093,14337,43634
m,m,1802,19,1725,460,26,133,483,1102
f,u,1926,5296,559699,184808,15408,40587,114196,354999
f,f,1916,3073,768850,152023,11222,30936,88173,282354
u,m,1821,357,16643,1206,78,374,240,1898
m,m,1992,22441,1265875,592070,39886,102296,266141,1000393
f,u,1991,12487,828593,398947,29619,76882,228516,733964
f,f,2007,8597,808656,441387,28524,71773,240154,781838
f,f,1912,3541,732676,136838,10669,29422,84956,261885
f,m,1963,6154,397771,193078,14036,36614,100256,343984
m,u,1957,19191,1653765,574473,43272,110438,273939,1002122
m,u,1845,414,64725,6385,451,2039,5113,13988
f,f,1976,3730,353440,150449,11500,26999,76398,265346
f,u,1944,3362,300820,112721,8331,20231,62007,203290
u,m,1886,2629,69687,9101,738,2739,2030,14608
m,f,1927,3261,286352,105227,8716,22397,52840,189180
u,u,1857,353,9297,949,94,302,181,1526
f,m,1884,2002,273499,63648,6065,16325,43417,129455
f,f,1955,3427,449043,169205,11093,27535,80500,288333
f,f,1931,2452,308569,121927,9652,23612,69379,224570
f,m,1935,5332,522647,198295,15195,37861,110250,361601
u,m,1928,8193,137796,35226,2646,8547,7554,53973
f,u,1861,155,19089,3277,249,1008,3576,8110
f,f,1887,2305,478432,94035,8735,22284,67857,192911
u,u,1814,27,107,17,1,9,1,28
m,m,1852,4445,667757,89397,7715,25631,63040,185783
u,m,1889,3646,96315,10499,922,3179,2481,17081
u,u,1989,21142,385603,120168,8464,25293,25716,179641
m,m,1915,10735,1568034,327628,22207,71587,162207,583629
f,u,1962,8351,748223,276752,21010,53426,152566,503754
f,f,1856,1494,389974,59110,5207,15229,48627,128173
f,u,1883,227,27428,5008,452,1362,3733,10555
u,f,1897,2381,92600,10660,928,2973,2770,17331
m,m,1901,7090,917167,167481,12392,40726,91973,312572
f,u,1966,7914,669807,271092,20699,52649,156060,500500
u,u,1910,1013,23831,3751,287,867,852,5757
u,u,1825,199,4193,411,51,138,137,737
m,u,1871,575,66096,11473,1085,2854,6951,22363
m,m,1993,24101,1399378,668117,44403,116116,298359,1126995
f,f,1913,3872,814079,162623,11869,34293,100167,308952
f,m,1881,1507,319801,59521,5649,14790,40217,120177
m,f,1878,3031,444157,75177,7038,17601,44538,144354
f,m,1988,6984,538458,249058,16008,42914,131459,439439
u,f,1803,86,2543,418,40,158,110,726
m,m,1849,2575,303557,44770,3719,13138,31530,93157
f,m,1959,5782,550683,199217,13766,34969,100080,348032
u,u,1959,13410,291375,69439,4564,15535,14183,103721
f,m,1921,3988,648934,160318,12658,34570,93343,300889
u,f,1926,1627,27980,7359,570,1891,1546,11366
m,f,1820,654,71915,17838,1513,5397,12577,37325
m,m,1948,16412,1417987,526700,35534,89576,234848,886658
f,f,2000,7283,786618,404944,26835,64994,214197,710970
m,m,1810,575,39430,11788,1074,3799,9320,25981
u,m,1903,3617,97602,13974,1033,3929,2816,21752
u,f,1806,123,7129,1126,64,365,363,1918
u,f,1993,5969,132987,42632,2891,7390,10348,63261
m,f,1880,3155,359021,80315,7041,20621,49895,157872
m,f,1847,1238,152471,21372,1753,6626,16295,46046
m,u,2004,23714,1101806,535885,39105,104249,275101,954340
u,u,1932,8845,220502,45832,2762,10254,9479,68327
u,u,1841,83,1964,208,18,82,53,361
u,m,1870,2055,64304,7496,660,2304,1359,11819
u,m,1882,3029,73812,9673,913,2908,2536,16030
u,u,1997,17894,384482,100818,7193,19974,21756,149741
u,u,1879,703,21023,1811,181,556,327,2875
u,f,1828,170,5477,545,37,199,115,896
f,f,1958,2960,327489,122286,8675,20912,61453,213326
u,u,1873,221,1259,243,41,98,62,444
u,f,1906,2060,67055,9397,751,2295,2299,14742
m,u,1858,1628,210036,30445,2716,7488,19219,59868
f,m,1825,759,119329,15358,1306,5132,15089,36885
u,f,2006,7127,134103,51085,3289,9120,10715,74209
m,u,1973,20999,1075287,512358,38221,102719,258736,912034
f,m,1812,128,13662,1790,140,686,1516,4132
f,u,1933,4925,554602,187586,15569,38525,112185,353865
m,m,2008,19078,1027215,613864,38802,104783,282333,1039782
m,u,1978,24384,1654171,631549,43776,119795,320299,1115419
u,f,1812,201,3465,691,60,286,212,1249
f,u,1968,10402,832515,349559,26248,72039,204611,652457
m,u,1841,203,21885,4491,324,1408,2899,9122
m,m,1960,17807,1391989,542446,36969,94420,234402,908237
f,m,1906,3055,464791,100070,7551,22296,62134,192051
m,m,1973,20706,1342889,603089,39457,100331,277554,1020431
m,u,1987,24104,1178456,555310,40936,105782,273040,975068
m,m,1979,22628,1705246,668653,42507,114325,300716,1126201
u,m,1811,198,6751,494,48,204,117,863
u,m,1980,11506,204271,60528,3888,11963,12886,89265
m,f,1875,3215,424526,91864,7955,22988,55178,177985
m,f,1833,1262,163714,27362,2493,8418,20173,58446
u,u,1967,23543,361776,105310,7528,25788,21983,160609
f,m,2006,7568,462371,268206,18063,45844,141744,473857
u,m,1822,248,7991,512,45,170,114,841
f,m,1923,4479,523361,178104,14201,36801,106179,335285
u,f,1864,1216,42283,4178,378,1328,1021,6905
m,m,1845,2331,351800,45207,3592,13528,32425,94752
m,m,1864,3722,572132,85960,7381,25017,54855,173213
u,f,1862,520,18686,2414,203,691,627,3935
m,m,1917,9373,1255439,281437,19547,58839,141918,501741
f,u,1938,3824,419961,161630,11408,29093,88109,290240
u,f,2014,0,0,0,0,0,0,0
f,f,1973,3669,286029,152080,11358,27365,76416,267219
u,u,1963,16615,369989,92624,6009,19266,18076,135975
f,f,1925,1726,210113,86129,6733,17818,50185,160865
f,u,1952,6118,693218,240221,19292,48999,140542,449054
f,m,1801,168,15717,2440,239,1154,2542,6375
f,u,2010,499,32820,12530,972,2324,7137,22963
m,u,1965,25010,1607411,665166,47988,128690,330229,1172073
u,m,2006,12669,159522,66161,3970,12709,13965,96805
u,u,1935,7340,160292,38956,2837,8401,8571,58765
u,f,1887,2444,98569,10476,924,3202,2407,17009
f,u,1980,8771,650478,278072,20787,52029,156511,507399
m,f,2004,14375,952692,441176,30744,78853,191595,742368
m,m,1900,6078,708110,138118,10475,33621,78672,260886
f,u,1928,5086,598306,210848,17107,44532,130075,402562
f,u,1943,3950,389272,137590,10292,24945,70971,243798
f,m,1832,412,95515,12496,1069,4146,10979,28690
u,u,1968,23386,377825,119028,8398,26816,24180,178422
f,m,1956,5544,580441,215054,14387,37727,108093,375261
f,f,1868,1455,342499,63425,5401,15533,47231,131590
m,f,2012,0,0,0,0,0,0,0
f,f,1978,3662,365142,179771,12542,29061,91933,313307
m,f,1968,7181,546512,224356,15929,40459,96287,377031
m,u,1816,196,14770,2674,233,910,2230,6047
u,f,1904,1923,63574,8853,629,2065,1781,13328
f,f,2006,7971,809534,439676,27885,69480,238888,775929
f,m,1894,3665,587090,107881,8656,26593,69932,213062
u,f,2003,6952,130553,46550,3077,8493,9954,68074
m,f,1911,5159,683655,142444,10989,31460,71355,256248
m,u,1852,407,74610,10483,904,3022,7022,21431
f,u,1890,348,49420,8127,775,2073,5722,16697
m,u,1825,421,50978,7100,828,2092,5764,15784
f,u,1812,78,8021,2705,239,813,2326,6083
u,u,1871,181,2973,410,33,145,93,681
u,f,1956,3065,61910,20011,1520,3847,3713,29091
f,m,1992,6932,492457,232953,15557,40068,116130,404708
m,m,1871,3265,466008,81054,7020,21039,51167,160280
f,m,1952,5893,637145,230748,16812,42188,115727,405475
f,u,1995,10557,741112,312588,22709,61375,187933,584605
u,f,1850,529,17451,1648,163,540,397,2748
m,u,1894,605,59970,14908,1377,3325,9044,28654
f,m,1839,580,88270,12607,915,4002,11259,28783
f,u,1807,47,3851,954,126,355,1096,2531
u,m,1997,15129,222202,71267,4914,14685,16667,107533
m,f,1814,863,80549,19426,1582,5777,16775,43560
m,u,2000,25099,1200668,559996,40658,111038,286575,998267
m,u,2007,26333,1423613,665996,45402,122008,330450,1163856
f,f,1983,3737,323759,182917,12663,30002,88447,314029
f,m,2001,7699,547125,256528,17053,44420,135586,453587
f,m,1931,3603,351644,128300,9617,25579,70914,234410
f,m,1927,5160,582127,195181,14848,41254,116629,367912
m,f,1925,2925,198469,88275,7273,18443,42525,156516
f,u,1939,2982,304345,100650,7248,19548,56514,183960
u,m,1904,3798,85811,14263,1097,4057,2635,22052
f,f,1905,1860,361815,71312,5216,14409,43254,134191
f,u,2001,8465,613065,274180,18922,49250,165870,508222
u,f,2013,0,0,0,0,0,0,0
f,m,1967,6772,525090,236667,16818,43601,121257,418343
m,u,1948,18467,1371664,526163,39575,105282,259231,930251
u,f,2009,3104,36909,21182,1275,3954,4746,31157
m,f,1930,4552,363127,136639,10489,28558,64444,240130
f,m,1951,5980,575572,223694,16165,41763,112850,394472
u,f,1998,6620,131802,35805,2338,7022,8444,53609
f,f,1917,3227,726427,150087,11517,30894,86759,279257
m,u,1986,27845,1524816,632325,46470,123121,315550,1117466
f,m,1933,4339,423519,153032,12641,30703,85329,281705
m,u,1917,2013,232756,47801,3922,11152,25035,87910
f,u,1959,6293,516528,185813,14381,38126,110611,348931
u,m,1932,6404,120437,30785,2157,7026,6669,46637
u,f,1996,8086,139943,43680,2913,8589,10365,65547
m,u,1870,475,78323,12169,1064,3397,7731,24361
f,u,1923,4463,532675,157088,12648,35644,104812,310192
u,m,1879,1135,32259,3411,319,1030,750,5510
f,f,2012,0,0,0,0,0,0,0
u,f,1954,3428,71146,19343,1414,4301,4013,29071
f,m,1877,1432,268226,40517,3785,10914,29707,84923
f,u,1889,350,52703,10559,922,2498,8555,22534
u,f,1936,2874,48715,12868,986,2950,3123,19927
m,f,1912,5573,690666,144854,11216,31709,76439,264218
m,u,1934,10017,725707,269887,20731,53833,140117,484568
f,f,1986,4513,425311,216372,14676,35413,110920,377381
f,f,1855,1218,336820,52524,4356,13737,44883,115500
f,f,1895,2411,521710,102156,8589,22195,67201,200141
u,m,1829,1910,89260,5197,451,1743,1208,8599
u,f,1827,500,10154,1197,100,483,307,2087
u,u,1880,227,4659,554,53,166,150,923
m,m,1876,4540,723542,114080,9710,30205,72789,226784
m,u,1838,257,22463,3071,228,983,2447,6729
m,m,1830,2228,306474,38503,3046,11963,32789,86301
m,f,1959,5083,414807,155430,11147,27511,67167,261255
m,u,1802,57,8322,1282,102,438,1100,2922
m,m,1897,8959,1137436,216071,16479,50136,118668,401354
u,u,1971,15485,356253,86776,5641,18804,18787,130008
f,m,1971,6480,408342,184050,13459,34146,95160,326815
m,f,1954,7327,577382,227136,16213,42817,106301,392467
u,m,1944,5622,81220,22401,1661,5257,4307,33626
m,m,1841,2368,364594,47036,3549,15767,34241,100593
m,u,1960,21372,1760344,665712,45036,127790,336357,1174895
f,f,1989,6308,486591,297731,19954,48550,151248,517483
u,u,1865,287,8431,1001,105,319,370,1795
u,m,1954,9063,152359,44631,2881,8499,8220,64231
m,u,1979,26324,1656173,624226,45058,120821,306244,1096349
f,f,1979,4710,483209,228018,16956,39190,120522,404686
f,f,1953,3118,414053,156246,10596,25810,77796,270448
m,u,1804,20,1057,677,43,229,689,1638
f,f,1872,1791,375071,60631,5781,15347,45144,126903
f,u,1830,522,64947,6946,733,2386,7155,17220
m,m,1898,12031,1825491,305226,22659,76430,177583,581898
u,u,1828,139,4489,257,22,81,63,423
f,u,1960,8035,695117,294981,21877,57305,162046,536209
u,f,1981,4148,72922,24147,1673,4842,5772,36434
u,m,1988,12540,190208,62544,3985,11785,13728,92042
m,m,1848,3049,448239,57364,4442,16217,41512,119535
m,m,1991,24342,1460598,678336,45047,117196,310139,1150718
m,m,1965,23056,1649549,649863,42888,112464,296502,1101717
f,m,1851,673,115272,17417,1406,5543,13731,38097
f,u,1999,10485,645310,323797,23198,60346,195936,603277
f,m,1800,85,17294,2222,150,806,1846,5024
u,f,1951,3205,60342,16980,1304,3544,3231,25059
f,u,1899,420,69132,11575,902,2721,8474,23672
u,u,1833,84,5202,247,24,122,91,484
m,f,1900,3582,387965,81752,6561,18218,43749,150280
f,m,1886,1918,342101,65469,5780,16713,44854,132816
u,f,1947,2855,45946,13561,1037,2946,2848,20392
m,m,1938,11718,1072373,376662,26240,68269,175114,646285
m,m,1815,507,58802,7698,631,2308,6088,16725
u,f,1921,1986,70625,10446,815,2608,2372,16241
m,u,1956,18940,1609860,577480,41350,110395,280099,1009324
m,m,2000,28863,1691576,795351,52060,135957,364247,1347615
m,u,1868,1070,153990,29222,2157,7515,16774,55668
f,m,2009,4804,248283,172057,11371,29638,87047,300113
m,m,1888,7238,1028203,177949,14027,44313,104760,341049
m,m,1995,24984,1839328,724089,45919,122879,330478,1223365
m,f,2002,13839,901946,406353,28822,72264,182451,689890
m,m,1866,5147,903077,149886,11766,36926,90158,288736
m,u,1919,2239,240923,58760,4682,11879,29508,104829
f,u,1862,328,73930,11494,988,2704,8083,23269
u,f,1960,3547,56049,16628,1257,3690,3386,24961
m,m,1819,825,102623,10791,871,3141,9404,24207
f,m,1901,2212,396106,69782,5171,16548,42894,134395
m,u,1989,30092,1562377,724284,51703,136551,358010,1270548
m,m,1835,2004,303181,38734,3092,11817,31353,84996
f,m,1864,1269,237785,40020,3706,11663,30157,85546
u,f,1958,3311,59657,18915,1265,3759,3659,27598
m,m,1854,3798,433460,60254,5072,17564,43863,126753
m,m,1893,10579,1576190,268829,20898,68214,149967,507908
f,u,1872,462,76318,13188,1293,3520,10046,28047
f,f,1888,2016,392227,78052,7329,19054,56360,160795
m,m,1896,14027,1598714,293294,23322,71849,169474,557939
f,f,1849,528,106843,17469,1422,4901,15605,39397
m,u,1889,839,84060,18613,1611,4541,11647,36412
f,f,1801,149,19969,2819,267,1275,3439,7800
m,u,1998,25432,1187260,581474,42828,113824,300797,1038923
m,m,1887,5588,749150,149834,12458,34946,84828,282066
u,f,1886,1895,65660,8144,766,2270,2013,13193
u,u,1933,6952,121651,29865,2302,6974,6213,45354
f,m,1854,1183,155498,22168,1976,6589,19167,49900
f,u,1822,110,23404,3496,174,1402,4370,9442
u,u,1854,432,16969,1336,108,481,308,2233
f,f,1810,338,58023,13213,1021,4859,13872,32965
f,u,1877,213,30050,5320,478,1347,3895,11040
m,f,1860,2399,281092,49358,4508,13186,32960,100012
f,u,1811,72,12413,2273,166,721,2542,5702
u,m,1806,86,2463,99,21,46,52,218
f,m,1957,5315,515602,192267,13085,35058,93475,333885
f,u,1971,7700,523242,231272,18215,46728,137890,434105
f,u,1907,458,67965,15189,1363,3678,9239,29469
m,u,1876,825,105422,14514,1313,3867,10135,29829
m,u,1921,2225,319123,73981,5498,15651,35679,130809
m,u,1857,992,118971,20205,1834,5343,14401,41783
m,f,1867,3118,508403,80799,7386,21518,48475,158178
m,f,1966,6242,526499,201504,13629,34502,84349,333984
u,u,1927,8065,138739,33360,2681,8919,6633,51593
f,u,1951,6283,651287,260888,20163,50489,148319,479859
u,f,1913,2671,84533,13051,1040,3278,3345,20714
f,f,1863,1161,341848,58435,5009,14771,42274,120489
u,m,1972,10203,154192,48771,3308,9665,10279,72023
m,u,1855,926,100761,17273,1605,4938,12019,35835
u,u,1823,30,355,123,8,28,17,176
m,u,1964,20818,1516985,578228,41198,113242,292349,1025017
f,m,1840,883,107969,19533,1665,6553,16763,44514
m,f,1916,5060,681706,147304,11505,32081,73655,264545
u,m,1812,1240,29983,6137,484,2152,1074,9847
u,f,1875,1479,31806,5672,550,1576,1596,9394
m,f,1815,867,196649,22594,1680,6626,16425,47325
u,m,1808,308,9857,1328,115,497,484,2424
m,u,1981,26148,1570847,597723,43604,117875,295413,1054615
f,m,1856,1468,218859,32630,2919,9873,24966,70388
m,f,1955,6983,597906,211327,14545,38380,93705,357957
f,m,1862,640,86098,14669,1301,4150,12227,32347
u,f,1975,3661,78051,19540,1242,3805,4343,28930
f,m,1811,223,17788,5483,456,1945,5831,13715
m,f,1819,255,23273,4179,377,1386,3169,9111
f,f,1911,2958,629616,123403,9455,26116,74293,233267
f,f,1941,2976,411380,137211,9961,24442,74218,245832
u,u,2009,3980,45834,19670,1409,3880,4404,29363
m,f,1907,4316,451048,98660,7733,21501,53706,181600
f,u,1879,513,115913,20130,1957,5346,15595,43028
u,m,1865,1608,39120,4320,365,1385,1018,7088
m,f,1920,6147,747504,167768,13578,36983,84108,302437
u,m,1941,5731,103073,26877,1960,5927,6017,40781
u,m,1923,6608,122585,30796,2327,7565,6760,47448
f,f,1808,66,11674,1608,141,577,1717,4043
f,f,1836,709,162753,23577,2083,7330,22424,55414
u,u,1996,19773,328996,94849,6443,20195,22743,144230
f,m,1874,1066,181957,35500,3327,9445,25188,73460
u,u,1945,8069,203052,44301,2985,9284,8407,64977
u,m,1872,3537,81019,7470,751,2421,1750,12392
m,m,1884,5849,658186,132141,11472,34042,78741,256396
u,u,1800,13,76,22,1,6,2,31
m,m,1892,9748,1182529,215935,18466,53199,126314,413914
u,f,1933,1816,32421,9591,697,2202,2184,14674
u,m,1801,300,9011,940,79,360,218,1597
u,u,1842,117,1385,197,30,45,50,322
f,f,1935,3181,395114,160736,12087,29717,88707,291247
m,u,1888,993,117135,17533,1481,4475,10888,34377
m,u,1819,169,29894,4306,330,1552,3170,9358
u,u,1896,466,10296,1465,104,379,327,2275
m,f,1803,172,15090,3980,312,1379,3335,9006
f,f,1944,2608,342524,122616,8911,20898,63431,215856
f,f,1966,3200,335381,136818,9512,22561,63425,232316
m,f,1874,2346,354573,62444,5594,15812,34457,118307
m,u,1805,11,110,65,8,21,88,182
m,u,1837,167,20730,2506,182,793,1900,5381
f,m,1918,3167,422699,102605,8054,21871,58133,190663
u,m,1956,10422,164636,47587,3391,9858,8672,69508
f,m,1905,2239,355374,68483,5378,15345,42534,131740
f,f,1831,381,93755,12986,1131,4057,12014,30188
f,m,1857,1583,251202,36927,3087,11346,31265,82625
m,f,1854,1664,223072,43584,4109,11717,30062,89472
u,m,1826,950,33405,2382,159,777,726,4044
m,u,1846,396,31001,3342,302,1132,2626,7402
m,u,1815,268,17470,3474,272,1098,2595,7439
f,u,2014,0,0,0,0,0,0,0
u,m,1933,8456,223405,40872,3083,8864,7800,60619
u,f,1952,3787,76989,22045,1662,4829,5085,33621
u,f,1844,620,13211,1753,181,627,394,2955
m,u,1951,17646,1542978,590954,43895,115375,292165,1042389
m,f,1841,1761,216692,36488,3104,11038,26975,77605
u,f,1866,1143,41050,3428,417,1076,849,5770
f,u,2003,7770,528958,256210,18168,48547,150099,473024
f,u,1814,16,10178,1501,113,407,1326,3347
m,f,1834,1113,217651,26511,2267,7935,17387,54100
u,u,1801,8,6,4,4,4,1,13
m,u,1893,968,93769,20691,1666,4885,12660,39902
f,u,1901,829,163981,29569,2473,6690,20389,59121
f,u,1945,4845,498807,172050,12601,30482,90526,305659
f,m,1870,1251,234939,39203,3402,10697,28614,81916
m,m,1983,23721,1483365,626427,40176,107993,277555,1052151
f,u,1970,11464,959401,357422,27403,72697,210578,668100
m,u,1982,25789,1625799,632110,46356,121919,315596,1115981
u,u,1994,21711,358194,113210,8269,24096,26115,171690
f,f,1981,4647,531306,243467,16193,39879,125107,424646
u,m,2001,12434,180554,61780,3802,11583,13340,90505
f,f,1827,789,191456,29580,2237,9723,23956,65496
m,u,1922,6391,398594,158492,11517,35942,81504,287455
u,m,1895,6195,155940,21837,1831,6451,4750,34869
u,m,1946,8736,180417,42895,2856,8364,8722,62837
f,u,1880,248,24243,5577,533,1386,4537,12033
m,u,1887,473,59423,10284,898,2531,6767,20480
u,f,1860,948,22900,3947,399,1226,1026,6598
m,u,1916,2036,218687,49238,3841,11291,27305,91675
u,u,1902,1363,45246,5387,421,1444,1125,8377
f,m,1893,3118,505342,90651,7758,23949,59929,182287
f,f,1875,2194,430754,87659,7884,21278,66907,183728
f,f,1846,650,170315,24161,2103,7136,20396,53796
f,m,1809,97,1008,1233,91,476,1160,2960
f,u,1915,472,70589,15820,1195,3572,9616,30203
f,f,1920,3627,776931,175716,12974,35054,101200,324944
m,m,1844,4451,817965,97356,6762,31352,67951,203421
u,m,2011,70,7555,1332,20,259,226,1837
f,u,1997,10096,633462,310700,22642,59545,181448,574335
u,m,1843,822,24990,2060,184,718,353,3315
m,f,1886,4390,587901,109362,9959,26084,65314,210719
m,u,1882,1968,155369,25411,2252,6649,17128,51440
m,m,1981,22648,1510127,657741,42484,109817,288945,1098987
u,u,2014,0,0,0,0,0,0,0
f,u,1847,77,7969,1420,123,480,1295,3318
m,u,1874,393,49669,8199,701,2185,5404,16489
f,m,1838,514,80664,11488,994,3763,10719,26964
u,u,1937,7486,159431,36726,2879,8243,7210,55058
u,m,1827,557,19579,1799,247,588,433,3067
f,m,1932,4373,423758,174190,13846,34183,93446,315665
f,m,1946,5504,538456,200611,14572,35747,100016,350946
u,u,1864,297,6128,577,70,177,169,993
m,f,1921,4822,627731,155982,12015,33404,74912,276313
m,f,1831,669,81215,10965,958,3300,8344,23567
u,u,1869,155,4425,617,50,147,203,1017
m,u,1880,574,70668,12138,1040,3325,7227,23730
m,m,1860,3422,512007,71891,6207,21186,49966,149250
m,u,1899,1218,143136,26309,2040,6149,15443,49941
f,f,2011,0,0,0,0,0,0,0
m,m,1811,448,43042,8508,634,2705,6910,18757
f,f,1999,8216,860962,414144,27352,67133,218695,727324
m,m,2002,23571,1350659,640152,40548,107581,288367,1076648
u,u,1915,1132,42241,6509,522,1449,1222,9702
f,u,1896,368,75515,13984,1206,3170,7976,26336
u,m,1962,9392,151162,47356,3052,9311,8521,68240
u,m,1800,69,780,116,12,63,14,205
f,f,1954,3554,452228,179235,12311,30898,92438,314882
m,f,1978,7017,492021,215676,15924,39165,101262,372027
u,f,1834,438,16563,1383,111,470,322,2286
m,m,1857,4740,800850,98283,7849,27795,67089,201016
u,f,1922,3164,83748,16056,1354,3632,3538,24580
f,f,1949,3057,461186,166884,11426,27353,83326,288989
m,f,1876,3015,465338,84220,7551,21071,50387,163229
m,u,1955,19025,1631819,575717,40504,106498,286391,1009110
f,m,1846,786,125213,17839,1392,5841,14872,39944
m,m,1925,12892,1290922,398462,29800,79496,217116,724874
m,u,1814,40,7755,994,92,298,679,2063
m,m,1846,2893,460326,58198,4203,17881,43183,123465
u,m,2009,7730,109123,44540,2817,8185,8948,64490
m,u,1924,10656,754259,257595,20268,54178,139110,471151
m,f,1981,8602,621067,266576,18715,48249,116519,450059
f,m,1817,131,15917,2697,234,854,2115,5900
u,u,1926,8153,156371,37181,2893,9326,7704,57104
m,f,1936,6189,476050,176625,13773,35397,84739,310534
f,f,1885,1897,405658,82958,7493,20504,59609,170564
f,m,1859,1604,235373,32198,2924,9304,27320,71746
f,u,1932,3922,389666,147666,11847,30003,88614,278130
f,u,1935,4476,490411,181491,14258,35211,110114,341074
f,u,1855,602,126096,20903,1856,6059,17173,45991
u,u,1993,22460,359303,123417,8812,25118,28290,185637
m,u,1851,489,47252,5851,535,1642,4547,12575
u,u,1884,145,2346,414,69,124,59,666
m,m,1998,23244,1494143,672734,42220,112983,316961,1144898
u,u,1868,437,6698,1345,124,450,195,2114
f,f,1894,2595,642404,107927,9264,25025,76381,218597
f,m,1858,860,151113,22525,1993,7204,17495,49217
f,u,1809,17,519,245,30,87,215,577
u,f,1858,844,23419,3312,308,932,672,5224
m,f,1983,7348,369319,202126,14807,37043,89148,343124
u,m,1817,219,6069,723,74,293,177,1267
u,f,1832,478,16167,1176,117,453,352,2098
m,u,1895,932,91072,20157,1708,4820,11353,38038
u,f,1982,4687,97740,33131,2189,6200,7293,48813
m,f,1991,12434,642273,334587,24561,61277,147877,568302
u,m,1818,290,7175,488,43,197,137,865
u,f,1854,702,15173,1874,214,635,380,3103
m,m,1958,16978,1530486,590454,38944,102079,248370,979847
m,f,1830,787,116640,15616,1340,4395,12652,34003
u,u,1912,1043,34365,5138,400,1216,1096,7850
u,f,1925,1477,27450,8299,684,1866,1891,12740
u,u,1890,412,10869,1439,153,372,304,2268
m,u,1878,600,73930,14692,1084,3571,7920,27267
m,f,2013,0,0,0,0,0,0,0
u,m,2004,12795,182065,61192,4184,11895,13713,90984
m,f,1958,6272,497983,182476,13359,32637,77747,306219
m,f,1998,13982,859043,392398,28238,73685,186838,681159
m,f,1938,5890,459909,170978,13789,33885,83927,302579
f,u,1981,9173,703878,300176,23381,58312,167116,548985
u,f,2007,7852,111457,42027,2968,8401,9589,62985
f,f,1984,4168,413324,199619,13146,32066,99413,344244
u,f,2005,7228,131186,45050,2971,8289,9727,66037
f,f,1948,3063,481719,167301,12071,28374,85237,292983
m,f,1832,1307,168457,28501,2485,7924,21267,60177
m,m,1829,4431,678530,65299,5210,18691,55299,144499
m,m,1881,4454,732947,118953,10501,29863,68859,228176
m,f,1949,5827,550945,187033,13549,33079,84449,318110
u,m,1951,9078,199071,49624,3414,10015,8855,71908
u,u,1847,92,2086,281,27,102,60,470
m,m,1874,3554,524847,86799,7631,21985,51578,167993
m,f,1986,8365,510771,229609,16672,42065,98729,387075
f,u,1823,91,21768,3566,301,996,2987,7850
u,m,1858,1577,63413,6611,450,2109,755,9925
m,f,2008,14587,689854,454096,32120,85351,210571,782138
m,u,1937,12481,1075057,356327,25712,68958,176245,627242
u,f,1935,2987,58610,16752,1375,3756,3469,25352
f,m,1808,151,13069,2998,290,1179,3765,8232
f,f,1886,2502,490403,98201,8920,22554,71306,200981
m,u,1983,27851,1712716,676908,47886,131048,336861,1192703
u,m,1985,10607,203907,58489,3491,10704,12240,84924
m,m,1807,160,9938,2537,186,853,2195,5771
u,u,2001,15698,271221,88193,6230,18234,20523,133180
u,m,1974,11844,181861,57687,3807,11896,11272,84662
u,f,1963,3129,51683,16829,1148,3419,3994,25390
u,m,1907,4162,132709,17782,1229,4820,3690,27521
m,u,1971,20867,1213265,497507,36646,97980,263019,895152
u,u,1946,13618,311712,63515,4544,14081,12629,94769
f,f,1826,313,74829,10542,879,3323,10310,25054
u,m,1987,10817,135740,52212,3352,9925,11003,76492
m,u,1811,131,17825,3845,284,1110,3548,8787
m,m,1916,10039,1452794,320503,22831,70643,159179,573156
u,f,1816,262,5463,777,63,286,162,1288
u,m,1957,9016,155332,42902,2916,8327,8421,62566
f,u,2006,9608,625640,331596,22190,55709,192705,602200
u,f,1869,1108,39084,4124,387,1268,1002,6781
m,u,1822,498,48657,5170,318,2030,4598,12116
u,f,1802,51,8060,401,37,187,102,727
m,f,1902,2617,321970,63744,4821,14001,35815,118381
u,m,1863,1238,38483,3522,344,1311,805,5982
f,f,1991,6834,638492,331439,23175,55649,169941,580204
f,m,1985,5733,502682,206623,13658,36254,102532,359067
u,m,1891,3854,130321,15947,1495,4326,3285,25053
m,f,1950,6502,525235,214523,15573,38741,94065,362902
u,f,1917,2318,57054,10226,783,2527,2347,15883
u,f,1805,74,1479,260,15,99,37,411
u,m,1906,3913,112911,16331,1266,4442,3628,25667
m,f,1802,138,17685,3189,316,1031,2500,7036
f,f,1852,1009,278852,45852,3570,11390,39539,100351
f,f,1830,417,83010,13519,1131,3969,14066,32685
f,f,1965,2649,285207,122059,8881,21365,59329,211634
f,m,1831,817,162248,17339,1370,5238,16476,40423
f,f,2013,0,0,0,0,0,0,0
f,f,1918,3135,649774,141475,10567,29357,81005,262404
f,m,1987,6640,450384,211207,14590,37092,107329,370218
m,m,1805,95,8796,1426,111,509,1212,3258
u,f,1891,1992,58639,7139,629,2069,1795,11632
f,f,1938,2897,445955,177803,12235,30256,105141,325435
f,f,1891,2449,589318,106827,9422,23890,73772,213911
m,m,1921,12014,1688560,396292,28331,82836,204519,711978
u,f,1863,722,16075,1948,182,606,434,3170
f,u,1865,424,65950,12013,1042,2850,8367,24272
m,m,1968,25981,1874068,784061,52820,134765,339445,1311091
m,m,1920,13201,1672208,391117,28578,84063,191333,695091
m,m,1936,13362,1122327,402728,29362,76086,200188,708364
u,f,1801,104,1310,259,24,79,71,433
m,f,1976,7128,483535,196466,14804,36234,82808,330312
u,u,2007,17583,285275,95394,6318,19180,22135,143027
u,m,1816,142,6743,394,50,157,88,689
f,f,1857,1376,340602,61142,5499,16420,48377,131438
u,m,1898,6945,240552,31336,2380,9076,6733,49525
m,u,1930,16198,1441159,479652,35094,104952,256826,876524
u,u,1883,339,9865,1033,96,348,293,1770
f,m,1865,1125,203916,31095,2580,8498,22481,64654
u,f,1874,958,29595,3741,327,1073,981,6122
m,m,1955,20354,1764266,675226,44918,114836,293837,1128817
u,f,1847,562,13221,1300,109,448,287,2144
m,u,1925,11296,897817,283801,21925,65118,157724,528568
u,u,1942,6507,117957,31836,2244,6872,6518,47470
f,m,1872,2188,386953,57618,4859,15886,40107,118470
m,u,1827,352,41543,5948,587,1666,4246,12447
f,u,1870,182,39548,5786,474,1471,4838,12569
u,f,1815,376,23737,1977,154,651,352,3134
u,u,1982,18910,382716,99256,6905,20461,21158,147780
f,f,1816,266,97949,12396,956,4299,10485,28136
m,u,1929,18833,1412883,467358,36253,102360,259597,865568
f,f,1937,2897,391484,161881,11464,26416,83790,283551
u,f,1964,3253,58606,21073,1542,4148,4416,31179
f,f,1972,2600,230380,96183,6722,16639,48416,167960
u,m,1877,2337,87543,8123,652,2479,1950,13204
u,u,1832,507,14230,1205,103,389,396,2093
u,m,1894,6322,166791,20816,1648,6164,3832,32460
u,f,1890,2309,84159,9258,901,2915,2134,15208
m,f,1892,4377,589808,113010,10481,26857,66040,216388
u,f,1912,2692,65533,10691,875,2877,2422,16865
f,u,1927,4387,392394,152107,12173,32828,92508,289616
m,m,1853,4279,363179,48717,4036,14607,34932,102292
f,f,1811,120,37586,7987,563,2586,7257,18393
f,f,1889,2555,599669,111655,10384,25743,77515,225297
m,f,1908,4758,617273,122238,9435,26997,62442,221112
u,m,1918,5309,130502,21295,1622,5318,4188,32423
f,m,1895,3791,611258,114617,9798,27430,72989,224834
m,u,1854,855,112405,15636,1357,3873,9274,30140
m,m,1928,14634,1260059,422216,30483,85652,217688,756039
m,u,1908,1624,190199,38129,2836,8688,20281,69934
m,m,1834,2720,494168,46523,3458,13722,37627,101330
u,u,1813,4,25,4,0,2,4,10
u,m,1809,223,3387,425,36,156,81,698
f,f,1877,1522,298180,59613,5708,15006,46028,126355
m,m,1803,305,11096,2274,220,886,1581,4961
m,u,1958,15350,1212518,467651,32429,87830,235492,823402
u,m,1839,911,30480,2735,191,935,570,4431
u,m,1912,6035,172312,24285,1888,6164,5578,37915
m,f,1918,5116,586636,140174,10421,29283,66284,246162
u,m,1908,4059,117634,19218,1402,4622,3540,28782
m,m,1878,5793,617741,108857,9693,29178,69541,217269
u,m,1940,5893,116983,31507,2215,6594,6585,46901
u,u,1807,55,591,118,15,43,25,201
f,u,1993,12984,790403,410550,29518,75310,234076,749454
m,f,1891,4150,595891,107597,9999,25940,62553,206089
u,f,1937,2672,71120,18277,1444,3649,3730,27100
m,m,1832,1417,266310,34163,2905,10418,26025,73511
u,f,1929,2560,57382,15975,1319,3332,3000,23626
m,m,1940,12615,1260320,439337,29189,76634,196603,741763
f,f,1939,2100,266936,102141,7312,17941,52015,179409
m,f,1863,1846,303935,54281,4726,14304,33251,106562
f,f,2004,7874,740935,363329,25191,60816,189435,638771
f,f,1951,3667,578408,195618,13326,32376,94583,335903
f,u,2009,2709,144189,104846,7412,19704,59127,191089
m,u,1824,191,16067,3729,320,1087,2437,7573
m,m,1822,662,74650,10057,803,2879,7567,21306
m,u,1997,25994,1305957,611090,44335,120978,307293,1083696
m,f,1901,3684,412845,80948,6561,17751,44470,149730
m,f,1987,9812,651669,290461,20424,52030,130557,493472
m,m,1820,689,68529,9665,762,2873,7096,20396
f,f,1934,2807,347946,140079,11001,25602,78303,254985
m,m,1827,1256,177427,21711,1989,6830,18137,48667
u,f,1811,90,2197,373,15,123,101,612
f,f,1867,1733,392927,71222,6933,17243,52571,147969
f,m,1940,3707,362876,145250,10507,27200,72926,255883
f,f,1896,3078,629987,108355,9786,24365,74254,216760
f,u,1800,5,348,27,0,7,12,46
f,u,1908,656,147043,26541,1914,6036,17564,52055
m,m,1850,3896,646396,81503,6539,24919,57677,170638
u,m,2008,10054,127758,54718,3226,9652,12456,80052
m,f,1816,488,94371,15326,1073,4905,10563,31867
f,m,1824,478,53262,8017,702,2654,7853,19226
u,u,1907,822,21280,3782,280,809,765,5636
u,m,1976,10578,150785,46247,3011,9502,9411,68171
m,f,1842,1139,132755,21412,1955,6337,15976,45680
f,u,1833,87,10656,2020,174,704,2116,5014
u,m,1949,7920,135952,34793,2325,7014,7098,51230
m,m,1862,2167,253104,42605,3664,11275,29534,87078
u,u,1957,12232,318708,74380,5190,16078,14893,110541
u,u,1804,30,173,96,6,38,17,157
f,u,1937,4392,512481,195021,14823,36177,112424,358445
f,m,1976,5733,430062,199397,13354,35422,100334,348507
u,m,1998,11557,211806,58817,3306,10761,12806,85690
f,u,2007,9996,609573,334219,22921,59011,189365,605516
f,m,2002,7188,540212,256732,16598,44306,137216,454852
m,u,1823,81,7314,1336,153,396,1146,3031
u,u,1898,331,5436,752,87,258,232,1329
f,m,1986,6146,459489,222582,14255,37474,112722,387033
f,f,1909,2855,590135,107909,8294,23283,65861,205347
u,m,1866,2309,81804,7597,710,2393,1477,12177
m,m,1990,24757,1529196,678327,44889,117782,308200,1149198
u,m,1830,1100,39439,3013,284,1217,651,5165
u,m,1848,1452,43649,3934,325,1449,865,6573
m,u,1850,51,5744,563,45,147,438,1193
m,u,1988,27315,1516613,650247,48071,122931,325637,1146886
u,m,1950,9722,240162,58059,3298,10939,11294,83590
u,u,1924,7278,144536,33792,2454,8389,6634,51269
m,f,1835,2638,351867,56949,5040,15716,40937,118642
f,m,1867,1081,213112,37814,3816,10322,27295,79247
f,m,1847,589,124189,19169,1517,5905,15419,42010
m,u,1890,828,71022,14147,1272,3548,8316,27283
f,u,1925,4051,471667,157819,11758,34114,100671,304362
f,u,1931,5587,502545,195593,16455,41568,118977,372593
m,f,1957,6239,500372,198908,14823,35934,81585,331250
m,f,1889,4314,674190,123345,11682,29916,70607,235550
m,u,1833,164,17625,3102,245,916,2169,6432
m,u,1839,559,81659,10325,729,3462,7474,21990
u,f,2011,0,0,0,0,0,0,0
f,f,1968,3656,390089,168381,11376,28220,83436,291413
u,f,1983,3995,66608,21439,1364,3998,4654,31455
f,u,1921,843,161025,33861,2715,7163,19536,63275
u,f,2000,7001,108523,41342,2795,8024,9533,61694
m,f,1992,12559,758503,359170,25469,64335,160753,609727
m,f,1807,268,38999,11850,699,4200,10392,27141
m,m,1828,1272,201049,20992,1678,6999,18236,47905
m,f,1985,9989,585936,258010,18120,46367,115839,438336
m,u,1867,637,76002,13992,1063,3739,9293,28087
f,f,1992,6663,707100,351234,22132,54957,177815,606138
m,u,1928,14297,1036205,395394,29574,84517,220145,729630
m,f,1858,1752,283221,47666,3882,12317,31463,95328
u,m,1835,990,38203,3068,301,1006,701,5076
u,u,1838,105,2701,175,17,44,42,278
m,m,1812,439,54309,8040,526,2703,5874,17143
u,f,1837,311,10048,782,74,275,232,1363
u,f,1948,2842,57200,16379,1155,3466,3108,24108
f,f,1952,3448,421286,157107,11613,28045,81500,278265
f,f,1839,590,108384,17464,1509,5063,16527,40563
u,f,1969,3414,54184,18710,1217,3599,3717,27243
f,f,1940,1910,272861,103045,7091,17045,49079,176260
u,f,2004,6961,118045,41679,2966,7782,9384,61811
u,m,1938,6056,106503,29517,2198,6268,5954,43937
m,m,1910,12546,1804076,351843,24754,81270,177585,635452
m,m,1972,18761,1131107,511772,33920,89644,227104,862440
u,f,1849,545,14855,1487,135,454,495,2571
m,m,1949,16583,1455716,508823,34228,88307,225291,856649
f,m,1807,75,8958,1528,120,516,1700,3864
u,f,1856,890,21216,2790,267,823,795,4675
f,u,1958,4827,475732,182978,13279,35001,103021,334279
f,f,1960,2998,329356,138002,9625,22894,66634,237155
u,f,1821,218,11174,1286,82,464,511,2343
f,m,1900,1986,238285,50174,4101,12499,34278,101052
f,m,2004,8378,535479,293437,19614,50518,153880,517449
f,m,1938,3519,342173,130634,9928,24527,65478,230567
u,m,1981,12474,238251,64438,4444,12275,13700,94857
f,m,1961,6641,549787,229337,16664,42731,114308,403040
u,f,1896,3727,147106,17760,1367,4977,3845,27949
u,m,1921,5734,160281,27878,2083,6921,6537,43419
m,u,1927,11918,826307,280682,22657,61660,154312,519311
f,f,1933,2148,233714,107254,7888,18690,60637,194469
f,u,1983,10460,791315,339094,25328,63793,185464,613679
u,m,1807,68,2106,319,18,84,86,507
f,m,1891,2390,412692,75958,6674,18160,50434,151226
m,f,1913,6276,841936,174874,13335,38223,90827,317259
u,f,1957,2995,57364,19524,1479,3953,3828,28784
m,m,1957,17260,1494620,559861,35598,93344,239285,928088
u,f,1979,4722,101477,36593,2037,6712,8411,53753
f,u,1996,11402,799381,360634,27343,68280,210013,666270
m,m,1932,13176,1177908,431935,31917,83906,203235,750993
m,f,2011,0,0,0,0,0,0,0
m,m,1997,26876,1912209,809721,51450,141553,374368,1377092
u,f,1971,2879,39984,13177,980,2729,2940,19826
u,f,1907,2298,62341,9355,749,2480,2080,14664
m,m,1858,2724,399946,55316,4556,16170,36661,112703
f,m,1821,221,24698,3442,302,1175,3176,8095
f,u,1813,33,7042,1787,146,574,1660,4167
f,m,1983,6338,435187,207050,13952,36737,105146,362885
m,f,1895,4260,591610,107037,9136,26119,57226,199518
m,u,1842,207,25510,2881,262,837,2401,6381
f,f,1842,563,129621,21311,1927,6192,18681,48111
f,m,1974,6073,367778,172038,12542,32156,88675,305411
u,m,1846,1369,25094,2951,280,1073,577,4881
m,m,1873,3019,440572,71127,5803,19194,44274,140398
m,f,1848,990,183577,26362,2262,7124,17827,53575
f,m,1892,3198,494306,99694,8482,24583,67345,200104
f,m,1972,5507,353706,165072,12018,31632,84816,293538
m,u,1990,34194,1841330,780781,56230,146907,403097,1387015
f,f,1848,661,213938,28413,2684,7888,25067,64052
u,m,1825,1389,46954,3846,321,1333,921,6421
f,m,1816,65,11422,1511,116,516,1631,3774
u,u,2008,9313,126897,47592,3455,9464,10631,71142
u,m,1978,11489,180851,58130,3746,11029,11353,84258
m,u,1865,888,102809,19507,1766,4971,11595,37839
m,u,1923,13380,1043099,324574,23975,73621,183596,605766
u,m,1841,1081,39828,3083,220,1205,662,5170
f,f,1906,2380,519258,96937,7823,20440,60749,185949
f,f,1943,2766,358405,135562,9330,22479,64714,232085
u,u,1929,14256,268858,60284,4300,15019,12621,92224
m,m,1869,3983,395809,67582,6409,18726,43724,136441
m,m,1813,125,6530,974,73,399,500,1946
u,f,1808,82,3157,348,21,143,34,546
u,m,1960,9423,163420,49337,3056,9603,9410,71406
f,f,1980,4542,459112,231720,15528,38672,120337,406257
u,m,1892,5271,170139,18245,1528,5632,3653,29058
f,f,1812,356,82106,14215,1281,5020,12626,33142
u,f,1911,2446,74275,12673,1002,3081,2990,19746
f,u,1805,7,218,60,3,26,86,175
m,f,1829,902,139395,15839,1440,4975,12801,35055
f,f,1969,3375,375023,162793,11439,27134,77330,278696
u,u,2013,0,0,0,0,0,0,0
f,m,1978,6757,548183,239536,16168,42266,115381,413351
m,f,1839,970,115153,16948,1370,4894,13571,36783
u,f,1972,3180,54664,14395,1089,3036,2983,21503
f,u,1806,18,116,264,30,115,374,783
m,f,1956,5815,526229,194939,14368,35032,83663,328002
u,u,1950,14890,395107,85298,5460,17798,16503,125059
u,m,1850,1938,73241,5790,486,2058,1344,9678
m,m,1956,19338,1611968,602852,39206,100842,263427,1006327
f,m,1930,5123,564297,184707,15006,38390,105134,343237
u,u,1837,116,7633,572,55,194,75,896
m,u,2006,23518,1240754,598539,40804,107169,302046,1048558
u,f,1838,585,17158,1136,142,528,348,2154
m,f,1809,453,78383,12775,1083,4156,9333,27347
f,f,1843,437,95540,12924,1108,4207,11931,30170
m,f,1883,3799,441911,96865,9645,24002,54734,185246
f,u,1955,5933,736745,245163,17671,46348,136937,446119
f,m,1925,3974,491252,169613,13231,34415,103834,321093
f,f,1837,413,92468,13979,1223,4129,13377,32708
m,f,1946,7510,713341,232192,16371,40646,101967,391176
m,f,1838,1190,158806,20932,1970,6928,17402,47232
m,u,1891,820,84972,17042,1544,4470,10587,33643
m,f,2001,13568,910060,416616,28790,75672,193687,714765
f,f,1998,7890,732198,374448,25031,60926,203995,664400
u,f,2010,205,2915,728,44,185,159,1116
u,u,1855,349,5859,884,93,299,253,1529
u,m,1880,2713,86467,8958,750,2635,2324,14667
m,m,1882,5931,609504,121759,11311,30833,75941,239844
u,m,1834,1300,65720,3810,292,1266,792,6160
f,f,1866,1417,379688,61915,6013,15233,47960,131121
u,f,1918,2306,46216,8972,736,2249,2023,13980
f,m,1826,489,93092,10641,800,3268,10460,25169
m,u,1906,1497,177904,34740,2754,8170,19235,64899
f,m,1875,916,207965,38789,3434,10154,27231,79608
u,u,1812,44,2063,120,16,50,40,226
f,u,1853,305,52368,8364,705,2427,6792,18288
f,u,1869,184,40586,6645,597,1701,6037,14980
u,u,1983,20102,400760,111496,7297,22253,23387,164433
m,u,1944,10634,709717,247487,17788,45882,121073,432230
m,f,1906,4102,572512,112841,8603,24749,61058,207251
f,u,1950,7439,854970,297886,23620,62818,174263,558587
m,f,1909,4984,621135,123576,9829,27902,63943,225250
m,u,1946,21679,1680840,568984,41622,105845,280012,996463
u,f,1833,610,21045,1635,155,690,478,2958
f,f,1910,3126,672899,131107,10342,27023,83512,251984
f,u,1878,218,29420,6314,540,1560,4838,13252
f,u,1882,639,63890,12095,1169,3189,9166,25619
m,f,1812,451,81035,13453,1122,4479,10221,29275
m,m,1950,17294,1891961,634969,40858,106473,287215,1069515
u,m,1916,4462,127013,19369,1496,5056,4636,30557
f,m,2008,5972,356038,229194,15239,40417,121465,406315
u,u,1949,11512,204914,54252,3778,11776,10172,79978
u,u,1824,42,443,51,3,21,18,93
f,f,1961,3041,335847,136077,9186,22346,66053,233662
m,f,1910,5329,667411,130383,10604,28701,69973,239661
u,m,1979,12412,216602,63086,4020,12257,13946,93309
u,m,1820,348,13187,1416,109,377,277,2179
f,m,1912,4317,750405,149868,12023,32797,86776,281464
m,u,1843,376,72475,7955,556,2319,5778,16608
f,m,1949,4954,471257,172930,12966,31803,87246,304945
u,u,1981,17988,319670,90720,6138,18413,20904,136175
u,m,1874,1711,62930,6197,579,1926,1380,10082
m,f,1811,169,8219,3471,242,1124,2989,7826
m,f,1974,6338,363587,174642,13376,33420,79924,301362
f,u,1922,2378,209412,79042,5983,18047,47649,150721
u,f,1898,2084,69783,7767,684,1982,1846,12279
f,f,1963,2897,317432,144717,9745,23994,69936,248392
f,u,1994,13199,927429,447439,32595,81854,254663,816551
f,m,1998,7462,514492,254601,16789,44387,140140,455917
u,u,1911,1196,19380,3911,350,1104,866,6231
f,m,1815,183,43800,3741,333,1027,3128,8229
f,u,2008,5480,374046,195331,15126,38655,114164,363276
m,f,1801,205,18582,4908,401,1693,3963,10965
f,u,1851,176,22514,3570,337,1001,3458,8366
u,m,1986,10854,166777,53845,3417,10194,10664,78120
u,f,1872,1133,34017,3404,334,1218,964,5920
f,u,1913,740,115892,22930,1985,4885,13878,43678
f,f,1820,379,61021,18881,1319,5939,14673,40812
f,m,2011,32,4590,1139,25,172,509,1845
m,u,1932,11816,869709,290546,21531,59686,155421,527184
f,m,1843,470,67277,8596,706,2872,7582,19756
f,f,1946,3751,509722,171626,12740,29092,89232,302690
u,m,1842,1106,53879,4286,320,1538,796,6940
u,f,1946,3474,58588,16915,1342,3562,3362,25181
f,m,1950,5686,620432,215114,14692,37865,106566,374237
f,f,1829,577,126956,19111,1645,5767,18105,44628
m,u,1902,2403,220600,42405,3483,10297,24466,80651
f,m,1991,7421,540780,266141,17975,46254,141752,472122
f,f,1879,1317,321592,63368,6190,14133,44170,127861
f,f,1995,7240,747979,366983,23543,59476,190864,640866
m,f,1923,2395,227518,73074,5499,14893,36049,129515
f,f,1962,2765,322572,126935,9077,21321,61360,218693
u,m,1896,7929,286528,29816,2364,8819,6027,47026
u,u,1882,1112,21971,2394,203,642,636,3875
f,u,1864,449,72127,11189,1030,2594,8257,23070
u,f,1809,279,7101,950,79,328,247,1604
u,m,2013,16,0,181,23,63,41,308
f,u,1804,14,1744,890,43,270,927,2130
f,m,1913,4445,778804,159187,12225,35140,96478,303030
f,f,1861,840,142632,23671,2350,6405,18694,51120
f,u,1832,433,41732,6404,576,2080,7600,16660
u,m,1955,11079,189492,57057,3937,11113,10457,82564
u,u,1876,346,10950,1170,127,387,330,2014
m,u,1864,971,117048,17175,1553,4220,10231,33179
u,f,1986,4277,71583,23832,1546,4584,5163,35125
u,m,1814,30,1026,175,16,59,36,286
u,m,1991,13007,228992,71428,4857,15293,15582,107160
f,u,1912,668,92835,20238,1639,4572,12858,39307
f,u,1837,84,20450,1620,88,509,1227,3444
m,m,1944,11230,900536,326219,22807,56088,145623,550737
m,m,1934,13998,1296203,463151,33973,89475,226105,812704
m,m,1954,18940,1651486,627107,41301,104459,270643,1043510
m,f,1999,14713,921687,444417,31406,78541,196740,751104
f,u,1969,12261,1026237,373140,30473,75407,219013,698033
f,f,1914,3013,665748,124584,9193,26767,75873,236417
f,f,1814,535,114367,22651,1791,7373,21425,53240
u,f,1941,2356,48967,13465,889,2613,3105,20072
m,u,1913,1954,212352,39935,3347,9416,20595,73293
u,u,1851,205,7022,498,33,163,120,814
m,u,1992,33662,1776158,829955,59899,158897,423212,1471963
m,f,1972,5651,331781,148483,10550,26204,64956,250193
f,m,1955,6105,661324,221169,16037,39718,109894,386818
f,f,1892,2893,642731,128861,12115,29836,89522,260334
f,u,1904,718,131398,24347,1963,5412,16640,48362
m,f,1837,720,88903,13890,1162,4192,11298,30542
u,f,1813,239,17568,1558,99,631,507,2795
m,u,1801,27,5024,798,80,274,565,1717
m,u,2005,25556,1253373,584102,41993,113990,296664,1036749
m,u,1847,270,39376,4830,405,1945,3981,11161
m,m,1926,14344,1089357,355990,26553,73730,191067,647340
m,u,1915,1295,161945,32664,2336,7709,17198,59907
u,f,1893,2427,84998,9633,906,2712,2445,15696
m,m,1861,1622,238577,37435,3092,9647,22821,72995
u,u,1958,12314,302677,84234,5442,16738,16369,122783
f,u,1916,787,142526,29564,2288,6506,19108,57466
u,f,1852,562,29124,3178,241,675,896,4990
f,u,1887,195,35935,5885,535,1421,4688,12529
u,u,1903,1012,18426,3038,280,814,672,4804
m,f,1884,3685,469549,90939,8510,21688,53287,174424
f,u,1946,6881,587970,233335,18208,43910,129121,424574
m,m,1818,630,57287,6465,575,2099,4771,13910
m,m,2004,25594,1545306,739110,47191,124521,335469,1246291
u,f,1919,2238,80004,10614,848,2893,2723,17078
f,u,1842,80,9033,1277,101,386,1260,3024
f,u,1982,8897,749616,301517,23067,57808,166539,548931
u,u,1815,123,5449,680,59,271,314,1324
u,u,1809,13,32,15,1,5,3,24
u,m,1952,9333,177880,49331,3533,10258,10398,73520
u,m,1853,2134,48751,5959,485,2012,1548,10004
f,m,1835,571,110173,13921,1127,4428,12805,32281
m,f,1905,3063,373445,80212,6014,17073,42899,146198
m,m,1895,12252,1573332,281215,21677,69508,160465,532865
m,u,2003,20345,1242414,509693,35476,97076,256767,899012
u,u,1944,6904,131232,32480,2313,6869,7548,49210
u,u,1874,146,1959,236,37,86,92,451
f,f,1834,726,202689,27847,2306,7993,23757,61903
f,m,1910,3666,584152,116181,8975,25847,70315,221318
u,u,1819,95,779,424,44,202,85,755
f,u,1818,97,11603,2544,295,883,2926,6648
u,f,1879,995,32426,4017,416,1146,1008,6587
u,u,1966,17866,377765,99552,6637,20966,21442,148597
m,m,1985,19495,1308857,577722,37309,99107,253769,967907
u,m,1983,12690,279867,71851,4310,13297,14919,104377
m,m,1839,2043,310326,38200,2649,11697,28324,80870
m,f,1827,1287,196748,29328,2073,8944,21390,61735
m,m,1899,17406,2087546,365082,28595,89472,210048,693197
m,u,1974,19505,1109404,487102,35064,95425,234834,852425
m,u,1907,1151,111496,24985,1988,5830,14024,46827
m,m,1946,18141,1421144,534230,37004,92427,237462,901123
m,u,1938,11886,831925,328376,23985,63532,165715,581608
f,m,1876,1482,292431,50975,4362,13532,40115,108984
u,f,1885,1384,38542,5925,577,1700,1569,9771
m,f,1915,5824,783072,164095,13025,37635,84341,299096
u,u,1916,1334,57542,8197,573,2430,1497,12697
u,m,1900,3306,101590,12587,951,3766,2617,19921
f,f,1977,3056,290462,131202,9243,22961,65968,229374
f,f,1822,452,89950,14879,1283,4940,13811,34913
u,m,1984,12408,175035,80548,4397,14835,17832,117612
u,m,1936,6378,86090,25348,1996,6118,5943,39405
f,m,1823,534,74469,10238,1016,3360,10214,24828
m,m,1808,335,48266,6914,601,2292,7273,17080
m,f,2009,6629,245776,221527,15541,41425,103752,382245
u,m,1873,1560,57852,5499,489,1695,1196,8879
u,u,1887,204,5356,593,34,169,138,934
m,u,1806,77,1355,1173,125,393,1100,2791
u,f,1931,2367,45804,12721,1043,3110,2997,19871
u,m,1876,2227,81675,8853,801,2595,1535,13784
f,u,1801,11,583,170,24,55,186,435
m,m,1911,12281,1905579,356598,25312,83261,182037,647208
f,f,1840,750,192767,27277,2305,8669,23641,61892
m,u,1898,625,78852,13579,1184,3346,7658,25767
f,m,1842,647,153841,24477,1813,7378,19776,53444
u,u,1899,746,28175,3519,245,756,670,5190
m,f,1800,245,18337,4947,503,1450,3370,10270
f,u,1989,12283,739727,378144,27057,69727,214758,689686
u,u,2006,17262,308185,106532,7314,20861,25261,159968
f,m,1863,717,110691,18946,1873,5432,14877,41128
u,f,1873,1121,29042,3643,402,1040,833,5918
f,f,2005,8065,816355,400597,26355,65939,216191,709082
f,m,1990,7650,579987,256555,17075,45062,132809,451501
f,f,1873,1755,442768,76078,6890,18184,55570,156722
u,u,1964,15832,297455,83978,5705,17602,16716,124001
f,f,1957,3292,386346,154212,11410,27336,75597,268555
f,m,1803,124,4626,1517,172,625,1850,4164
u,f,1984,4072,76568,24598,1616,4640,5665,36519
u,m,1992,11367,136973,47522,3391,9913,10424,71250
m,f,1851,1471,172641,28880,2877,8590,21479,61826
f,u,1990,13798,929022,430040,31451,78202,244122,783815
f,u,1924,4096,457282,152626,12257,32024,93642,290549
u,m,1831,1839,72227,4320,333,1394,1036,7083
m,m,1918,11089,1363021,301156,21863,64762,147301,535082
m,m,1906,8583,1240714,233456,16743,52212,123276,425687
u,u,1955,13455,354300,76437,5245,16611,15585,113878
f,u,1857,448,79470,14108,1153,3803,11740,30804
m,m,2005,23526,1401545,702459,45659,121326,321895,1191339
u,u,1844,126,2271,432,39,178,88,737
f,f,1864,1373,359293,59991,5124,15025,45214,125354
f,f,1936,3452,464701,171428,13228,31619,95669,311944
u,m,1803,147,2368,286,26,109,62,483
m,m,2009,14018,736612,453559,28375,75832,198561,756327
m,m,1809,346,21085,4916,372,1616,3521,10425
f,m,1848,806,135904,18926,1487,5702,16551,42666
m,u,1996,28619,1543052,626256,46335,125038,316349,1113978
f,u,1909,549,106208,21206,1606,4629,13511,40952
m,f,1843,897,125070,18763,1446,5659,15325,41193
m,f,1940,4250,331183,124167,8631,23096,53769,209663
f,u,1817,75,9578,2241,186,1049,1892,5368
m,m,1894,11487,1552366,275628,21071,67497,154856,519052
u,m,2012,0,0,0,0,0,0,0
m,m,1800,148,29705,4550,341,1418,3135,9444
u,u,1853,226,7686,805,56,268,122,1251
m,f,1872,2825,384462,65152,6173,16549,39745,127619
f,f,2009,3667,196605,189112,12809,31440,105190,338551
u,u,1867,327,7680,689,62,240,165,1156
f,u,1876,322,68523,11456,1016,3060,8863,24395
f,f,1859,915,169490,28534,2507,7417,24749,63207
m,m,1877,4489,711421,100432,8707,26505,64443,200087
m,m,1930,16184,1523153,493153,36546,98405,250086,878190
u,m,1999,12060,217769,62349,4089,11900,13723,92061
m,f,1941,5436,516191,177539,12666,33557,83427,307189
u,f,1928,2013,41352,10398,847,2507,2371,16123
m,f,1865,2944,408515,70513,6496,18098,43003,138110
m,f,1904,3404,375351,75927,5613,17430,42596,141566
m,u,1877,419,46866,8454,737,1927,5358,16476
u,m,1819,442,15021,862,73,281,309,1525
u,m,1905,3133,100094,13245,894,3504,2450,20093
f,m,1968,8060,630543,265892,19744,49410,136534,471580
u,m,1958,9054,150461,47482,3661,9907,9313,70363
f,f,1899,3109,701531,118860,10093,26300,79159,234412
f,f,1800,184,32416,6557,678,2156,6144,15535
m,u,2009,7049,239746,162329,12030,31288,82687,288334
f,m,1934,4552,453531,171512,14392,34870,96221,316995
m,f,1882,3196,456886,88671,7541,21611,48852,166675
m,f,1933,4224,345139,131288,10155,25820,64522,231785
u,f,1894,2058,66545,7806,669,2295,2240,13010
f,f,1850,806,264594,39052,3374,10915,31702,85043
m,m,1986,20033,1222935,567807,36362,95905,251941,952015
u,f,1851,582,13113,1361,132,536,481,2510
m,m,1826,1942,345521,38874,2767,11286,31942,84869
u,u,1818,54,311,79,7,30,18,134
f,u,1976,10180,856104,329126,25250,64415,187843,606634
u,u,1922,4342,67143,19301,1577,5090,4563,30531
u,m,1815,232,2948,223,34,88,67,412
f,u,1934,3693,351307,137213,11366,27170,78732,254481
m,f,1822,617,102815,20596,1639,5962,15757,43954
m,f,1885,2997,448968,85779,7878,21595,47289,162541
f,m,1960,5692,470057,190616,14518,35387,95944,336465
u,u,1984,17559,356126,91454,5877,21369,18227,136927
u,m,1885,3638,102617,11781,921,3354,2468,18524
m,m,2011,85,6866,2098,62,266,1015,3441
f,m,1908,3041,492518,110031,8534,25226,68594,212385
f,f,2002,7549,685288,352453,23209,56579,186381,618622
u,f,1995,6852,104367,34525,2414,7316,8674,52929
f,u,1867,294,57774,10382,786,2413,7245,20826
m,u,1959,18408,1294082,452026,32689,92305,233323,810343
u,m,1966,13335,213010,68831,4331,13034,13737,99933
f,f,1858,966,290064,46213,3952,12236,35726,98127
f,m,1915,3349,567942,124931,9589,27103,71782,233405
u,m,1945,6716,117295,30958,2127,6403,5409,44897
u,m,1920,5772,149282,24563,1754,6244,4904,37465
f,m,1828,455,67348,8161,740,2760,8440,20101
f,f,2010,102,5874,1472,115,337,808,2732
f,u,1839,251,47325,5893,501,1869,5334,13597
m,m,1976,20369,1384400,588209,37173,99883,268136,993401
m,m,1907,9638,1273829,258212,18865,58928,134392,470397
m,m,1994,22572,1438551,638163,42117,109016,285132,1074428
m,f,1866,2553,420225,66912,6315,17197,42525,132949
m,u,2001,21466,1184865,506443,35731,94242,260783,897199
f,m,1995,7694,684710,290075,18412,49039,152290,509816
u,u,1931,11288,228684,53548,3523,12426,11852,81349
m,u,1939,9984,906013,282443,19000,52755,139311,493509
f,f,1901,2145,379338,72697,6312,15322,46261,140592
f,f,1871,1422,360684,58635,5341,14145,43035,121156
u,u,1900,623,13286,2108,165,661,499,3433
u,m,1887,3591,116362,15252,1256,3942,3199,23649
u,f,1845,1296,42577,3082,285,1255,857,5479
f,m,1926,4177,495329,159479,12793,32080,93016,297368
f,u,1988,10995,765589,344839,26242,65647,199596,636324
u,m,1828,695,24116,1794,156,630,476,3056
f,f,1865,1841,521079,88989,8177,22022,65761,184949
f,u,1940,3225,399764,139499,9912,25206,71168,245785
m,u,1995,25811,1303446,566922,40260,111577,292815,1011574
u,m,1909,4241,106024,16092,1212,4270,3718,25292
m,u,1830,1415,237543,24984,2187,8284,20414,55869
m,u,1941,10172,875130,294576,20616,59493,149766,524451
u,f,1825,147,2856,381,38,147,84,650
m,f,1850,1291,213168,30835,2540,8326,21782,63483
u,f,1966,3100,54325,19226,1284,3793,4203,28506
u,m,1805,106,2667,510,45,203,120,878
u,f,1916,2333,63943,10500,851,2648,2272,16271
f,u,1852,213,47172,6725,540,2016,5029,14310
m,f,1826,612,79425,12186,969,3702,10300,27157
u,m,2002,12515,169289,59803,3896,11082,11885,86666
m,u,1901,2414,304800,56615,4619,13828,31196,106258
u,m,1833,1090,45818,3467,277,1012,757,5513
f,m,2013,3,0,18,3,2,9,32
u,f,1820,266,9505,1686,117,602,344,2749
f,u,1898,280,40583,8707,741,2098,6526,18072
f,m,1830,633,108653,13445,1129,4642,14155,33371
m,m,1952,17980,1559251,596756,41447,104417,264228,1006848
f,f,1967,3332,316109,139618,9748,23783,69019,242168
f,f,1915,3581,850187,165250,12307,34383,101148,313088
m,u,1800,15,602,110,6,44,104,264
u,f,1999,7324,100685,38293,2720,7704,9335,58052
m,u,1829,125,24355,4193,397,1288,2785,8663
m,u,1831,303,26813,4925,469,1536,4102,11032
u,f,1840,518,18335,1699,156,533,411,2799
u,m,1867,1375,37858,4383,413,1316,926,7038
m,u,1942,10881,968901,316963,22282,57389,147763,544397
f,m,1993,7476,492767,244835,16758,43343,124175,429111
m,u,1943,12559,935303,343405,24236,61481,158796,587918
f,m,1805,30,590,296,42,119,289,746
u,u,1999,17390,313030,99873,6635,20378,24563,151449
f,m,1861,529,95783,14641,1386,4190,11010,31227
u,u,1988,18852,327382,102103,7037,20575,22114,151829
m,f,1855,2170,318550,48625,3782,12893,31411,96711
m,f,1824,749,163675,23987,1964,7334,17090,50375
u,f,1855,820,31031,2156,188,684,386,3414
u,u,1925,8342,201413,40339,3014,10674,8157,62184
f,u,1824,79,12647,3542,324,1293,3192,8351
u,f,1839,496,14660,1716,127,621,452,2916
m,f,1988,12201,899039,356782,24595,64338,163438,609153
f,u,1965,8289,628406,260879,20922,53186,147037,482024
m,u,2010,1210,52330,23369,1864,5104,12788,43125
f,f,1828,282,66833,10507,862,3448,9627,24444
u,f,1853,507,20832,1639,172,558,340,2709
m,m,1838,1608,198185,26978,2154,8227,20537,57896
u,m,1910,5056,124093,18932,1432,5209,4424,29997
f,u,1906,549,74937,17174,1293,4074,10715,33256
f,f,1996,8424,873598,403745,26110,65157,210798,705810
m,u,1993,31377,1407827,743915,54621,141342,374508,1314386
u,u,2012,0,0,0,0,0,0,0
u,m,1937,7788,115746,30055,2342,7035,6396,45828
m,m,1868,3216,482537,84331,7035,22723,49164,163253
f,u,1948,6497,576805,236167,19677,48206,135710,439760
u,f,1800,93,2184,266,32,108,52,458
f,u,1984,8964,618187,310175,22930,57280,176895,567280
u,u,1930,12148,322451,69835,4887,15583,14675,104980
u,f,1991,6164,112912,37659,2763,7409,8571,56402
m,f,1828,454,101560,12816,1062,4138,9634,27650
f,u,1844,135,22813,4484,294,1334,4267,10379
u,u,1885,311,9185,1047,121,295,301,1764
u,f,1990,5637,114613,35875,2604,6806,8662,53947
m,f,1935,6119,467494,171482,13447,33954,85197,304080
f,m,1907,3019,507768,96375,7329,21492,58906,184102
u,m,1989,12602,164147,56374,3740,11009,11319,82442
f,f,1813,410,69483,11315,803,4020,14119,30257
u,u,1905,889,38453,4621,333,1169,1006,7129
m,u,1903,2264,290905,55010,4141,13019,30731,102901
u,f,1842,551,16665,2139,180,771,387,3477
f,u,1941,3925,494057,155005,11249,27147,86397,279798
m,f,1963,5827,489308,199557,13874,36204,87104,336739
f,f,1803,123,22452,3282,232,1277,3730,8521
m,u,1881,554,59812,11485,1078,2957,6669,22189
m,u,1807,99,8514,2105,205,700,1736,4746
f,m,1873,1075,210643,34011,3059,9367,25346,71783
m,u,1863,530,79541,12179,1110,3017,7774,24080
u,f,1814,364,3913,1305,93,483,315,2196
f,u,1854,362,78115,12317,1024,3224,9126,25691
f,u,1929,6456,792649,244913,18691,53955,155566,473125
f,m,1973,6272,391816,180981,13236,33636,92597,320450
m,m,1939,10185,863677,310757,21332,56704,146584,535377
u,u,1921,1190,27757,5120,397,1226,1061,7804
m,f,1967,6181,428632,183238,13379,33171,77371,307159
m,f,1818,610,69041,13633,1303,4307,10668,29911
f,m,1965,6598,496035,199188,13874,36095,100364,349521
f,m,1850,1481,410464,53699,4105,16421,45710,119935
u,u,1875,203,2653,576,55,191,132,954
m,m,1919,11033,1632679,366934,26318,78437,180645,652334
f,m,1829,1055,190818,19902,1546,5811,19876,47135
m,u,1949,15546,1067916,416626,30020,82234,205493,734373
m,f,1879,2117,287902,59879,5535,14040,34281,113735
f,f,1927,2020,273009,102127,7955,19968,59377,189427
m,u,1926,13137,969136,321498,25399,73022,180448,600367
u,f,1830,314,14831,929,102,364,252,1647
m,f,1931,4487,415701,156209,12540,31450,75410,275609
u,f,1876,1281,51878,5858,586,1556,1736,9736
u,u,1806,55,299,189,24,109,48,370
m,m,1891,6584,842869,158444,14088,38003,90529,301064
f,u,1972,7935,716045,274834,21001,55131,162227,513193
f,u,1930,6180,714607,238522,18413,49959,137790,444684
f,f,1870,1414,363047,65478,5804,15930,47835,135047
f,u,1816,129,15685,2150,254,781,2071,5256
m,m,1817,277,25433,4816,356,1362,3128,9662
m,m,1978,23241,1664147,708634,45193,117443,308590,1179860
u,f,1962,3297,51423,18137,1260,3901,3345,26643
m,u,1853,587,69493,11109,984,3218,7505,22816
m,m,2001,24093,1277275,626395,40543,107903,290191,1065032
f,m,1936,3834,418384,153752,11821,28618,84176,278367
u,m,1971,11764,168532,51949,3701,10430,10325,76405
m,m,1987,21069,1422083,643799,41044,107907,281746,1074496
m,m,1902,6103,740469,144604,11274,36575,79890,272343
f,f,1821,309,101803,19079,1472,5123,17638,43312
m,m,1974,21410,1227444,575560,38248,100125,266328,980261
u,u,1913,1317,34387,5607,436,1402,1108,8553
u,u,1872,343,7488,873,79,288,253,1493
m,f,1997,16613,1051553,469060,32491,84915,223204,809670
f,m,1984,6650,499289,225102,15374,39712,111452,391640
m,u,1952,16882,1552239,522044,39712,106922,266484,935162
f,f,1825,287,101243,13250,955,4120,10201,28526
m,m,1831,3727,560581,56166,4265,16038,46054,122523
m,m,1816,368,26379,4959,461,1593,4470,11483
f,f,1907,2482,540694,110722,8401,21902,66697,207722
u,u,1909,920,32766,4418,341,1107,768,6634
f,m,1841,673,130045,15689,1300,5856,13469,36314
f,u,1891,368,48905,10707,1090,2849,8045,22691
m,m,1943,14337,1215435,424582,29269,70698,180370,704919
m,f,2014,0,0,0,0,0,0,0
m,u,1885,455,50513,7558,716,1983,4894,15151
f,f,1835,1695,320639,50629,4867,14156,44586,114238
m,m,1837,2255,411025,50456,4033,14820,37612,106921
u,u,1805,10,18,23,3,6,1,33
m,f,1894,4722,648480,115976,10408,28572,67735,222691
f,m,1999,6932,515408,268176,17722,45484,140677,472059
u,m,1810,342,6050,785,82,264,219,1350
f,u,1987,9336,600274,287349,22458,54473,160765,525045
m,u,1861,457,45330,7130,644,2138,5336,15248
f,m,1852,1468,284967,35824,3245,11138,29212,79419
u,m,1934,8465,264102,41940,2832,9510,8870,63152
f,m,1813,68,3138,394,36,182,422,1034
u,u,1951,10210,216711,56113,3840,11921,11280,83154
m,f,1846,907,121250,20590,1844,5540,15091,43065
f,u,1841,63,6884,1557,116,443,1310,3426
u,m,1968,14431,207780,70042,4530,14212,13951,102735
f,u,2013,0,0,0,0,0,0,0
m,f,1922,7059,825646,198215,15869,42838,99500,356422
u,m,1897,4825,161826,19770,1483,5695,4275,31223
m,f,1932,3872,335954,129645,9934,25866,65319,230764
u,m,1856,1501,55702,4579,413,1469,963,7424
u,f,1884,1804,48144,6481,620,1908,1584,10593
f,f,1881,1930,415567,80861,7125,18950,56549,163485
m,m,2007,23452,1380695,721694,46318,119582,323958,1211552
u,m,1849,1310,35927,4003,306,1422,778,6509
u,f,1877,1417,54105,6935,560,1866,1929,11290
u,m,1930,8514,155513,37643,2721,8804,7904,57072
f,u,1858,726,118661,21198,1938,4941,15906,43983
u,f,1988,6717,116376,44621,2803,8263,10218,65905
f,m,1902,1974,341016,62313,4784,15538,39720,122355
f,m,1996,7583,539619,244633,16024,41857,131282,433796
u,m,1925,6842,142262,32261,2380,7271,7115,49027
u,u,1904,927,29007,4042,320,1118,812,6292
m,m,2010,380,8040,7744,527,1303,2957,12531
f,m,1897,2776,544167,97366,7728,23595,63407,192096
u,m,1878,2810,55290,7936,750,2298,1790,12774
u,f,1968,3578,59895,19113,1298,3919,3989,28319
m,m,1982,21257,1692228,663636,42056,111308,290489,1107489
m,m,1859,5095,698524,89332,7692,24694,64385,186103
u,m,1994,11832,189671,58779,4068,11838,13003,87688
f,f,1833,722,159141,24457,2112,7429,21706,55704
f,u,2004,8776,489481,267766,19657,50091,163046,500560
m,u,1947,19187,1698040,595636,44083,109944,289296,1038959
f,m,1819,203,38757,3815,342,1110,3684,8951
f,f,1997,8810,843123,387500,25119,64877,214099,691595
m,f,1873,2618,398762,71384,6505,17729,40349,135967
m,f,1962,5811,477818,193038,13492,33940,84510,324980
f,u,1903,1000,175964,31658,2476,7103,20646,61883
f,f,1993,6494,564093,294463,19547,48473,157150,519633
m,f,1825,433,74095,11351,919,3236,7577,23083
f,f,1819,178,18458,3096,320,1056,3146,7618
f,u,1875,134,23137,4914,497,1182,3587,10180
m,f,1977,5866,357537,161205,12023,30161,72122,275511
u,m,1875,1484,52271,5637,526,1669,1276,9108
u,f,1924,1339,19084,5437,401,1290,1307,8435
f,m,1958,5289,473677,191429,13897,36097,94009,335432
u,f,1901,1929,50941,8216,596,2070,1828,12710
f,f,1860,1497,305929,52524,4628,13386,40342,110880
m,f,1844,1302,194790,28761,2371,8589,20942,60663
f,u,1911,756,109314,20632,1747,4903,13519,40801
m,u,1809,51,2053,843,83,296,672,1894
u,f,1841,766,26869,1979,194,748,518,3439
m,u,1963,21619,1418901,577408,41788,113666,293573,1026435
u,f,1892,1993,68182,8279,765,2439,2105,13588
f,m,1916,3120,555767,126959,9829,27377,70426,234591
m,u,1920,2636,339571,75564,5877,15803,39454,136698
u,u,1878,284,9990,914,91,235,229,1469
f,m,1880,2155,383906,58468,5054,15265,41656,120443
m,u,1935,12579,1115827,367321,27926,70121,189299,654667
u,f,1804,97,5046,317,28,132,33,510
m,u,1860,1071,150923,23339,2057,6267,16576,48239
f,m,1820,183,15485,3313,277,1040,3078,7708
m,u,2014,0,0,0,0,0,0,0
u,u,1940,6756,167464,44078,2930,9702,8317,65027
u,m,1883,4952,114331,11883,1078,3706,2821,19488
f,f,1932,2026,284954,125376,8990,22201,69282,225849
u,m,1902,2870,71265,11736,957,3258,2482,18433
u,m,1953,8991,176784,47190,3240,9793,9010,69233
m,u,1821,234,25095,5743,422,1767,5360,13292
f,u,1885,162,17855,2609,287,710,2080,5686
m,u,1961,23388,1864360,692241,49199,134983,360140,1236563
m,f,1870,2237,312911,60346,5525,15037,35000,115908
m,f,2006,14443,909560,478410,33306,86197,219588,817501
u,m,1845,1112,41141,3532,283,1128,608,5551
m,m,1975,18680,1370167,580862,36837,100338,263141,981178
u,m,2014,0,0,0,0,0,0,0
m,f,1984,7962,541564,230182,16116,41880,102854,391032
u,m,1917,4403,118746,20665,1573,5342,4227,31807
u,u,1827,202,4686,503,45,215,113,876
f,u,1917,696,115771,23257,2084,5414,16476,47231
m,f,1903,3380,362997,83059,6569,18225,44701,152554
u,m,1864,1673,47538,4289,476,1504,1256,7525
f,f,1809,295,57536,9582,919,3274,8879,22654
m,f,1952,7171,593162,229980,16796,42095,106338,395209
f,m,1887,2049,329164,64968,6001,15474,43992,130435
m,u,1991,32912,1465051,721609,52777,138427,365935,1278748
u,u,1954,10761,290059,74972,4562,14736,14413,108683
u,m,1926,8206,230020,32170,2454,7742,7023,49389
m,f,1943,5402,434803,163779,11962,30384,72160,278285
f,m,1845,751,121622,17880,1460,5371,15215,39926
f,m,2014,0,0,0,0,0,0,0
m,f,1980,8457,501801,241033,17407,44516,110239,413195
u,m,1913,5514,155432,23279,1769,6258,5096,36402
m,m,1804,470,32269,6224,575,2166,5061,14026
m,m,1941,11077,1009477,348670,23437,62003,160767,594877
f,f,1964,3120,329161,142776,10422,23789,66712,243699
m,u,1818,126,9905,1826,179,609,1880,4494
f,u,1918,574,90409,19082,1456,4580,11294,36412
u,f,1881,1448,47199,6069,526,1759,1433,9787
m,f,1970,8652,549648,221126,16615,41477,94845,374063
u,f,1908,2306,72290,10136,755,2382,2140,15413
u,u,1856,196,6135,321,30,125,84,560
f,m,1814,8,0,37,3,7,47,94
u,u,1849,151,2664,260,16,78,53,407
m,m,1883,10395,1185323,204125,18658,54002,129951,406736
f,u,1874,173,29973,4754,411,1344,3960,10469
m,u,1866,319,34734,6165,659,1653,3725,12202
m,m,1914,11950,1804627,356544,26179,77006,175369,635098
u,u,1990,23420,443418,127443,9168,25965,28162,190738
f,m,1945,4119,375836,142311,10822,25766,69992,248891
u,f,1976,3417,72523,23184,1536,4459,4927,34106
m,u,1848,317,38865,5311,452,1619,4203,11585
f,u,2011,4,0,0,0,0,1,1
u,u,1969,21535,362518,100934,7516,22004,21003,151457
f,f,1942,2449,397028,133234,9798,23484,70313,236829
m,m,1924,13400,1215222,406834,29849,80757,207527,724967
u,u,1948,11076,233805,54760,3927,12561,10428,81676
u,u,1810,111,711,155,17,72,54,298
m,f,1928,3686,315112,117284,9156,23359,56756,206555
m,m,1903,7624,940695,181032,14002,43567,98663,337264
u,m,1890,4515,162539,16054,1347,4897,3375,25673
f,u,1949,5205,466801,185251,13571,33659,97712,330193
u,f,1910,2456,72571,10774,915,2817,2551,17057
f,m,1937,5097,504133,197780,15083,36408,100349,349620
u,u,1850,54,5146,371,14,117,45,547
u,u,2004,17416,286917,96104,7060,20448,23168,146780
u,u,1897,344,19571,1482,117,302,336,2237
m,u,1970,35116,2014108,775198,59901,162077,412142,1409318
m,u,1945,13940,1147630,386544,28046,68509,182630,665729
f,f,1970,3964,380657,159487,11925,27569,75513,274494
u,f,1915,2533,60561,11052,909,3007,2505,17473
f,u,1893,388,58402,12138,1123,2657,9130,25048
f,m,1878,1984,240398,47630,4382,12418,35313,99743
m,u,1900,1460,147366,25299,2069,6209,13954,47531
u,u,1817,55,960,158,25,72,52,307
m,m,1872,7274,1085928,140704,11567,38796,84872,275939
f,f,1903,1953,366199,76689,5842,16164,48802,147497
f,f,1947,3584,467696,174182,12736,28925,86772,302615
m,f,1989,11048,573599,310183,21326,56832,135934,524275
f,f,1823,291,74471,13114,1180,4501,11177,29972
m,m,1989,24456,1487936,687827,44007,117054,306039,1154927
m,u,1835,404,45880,5552,391,1713,4744,12400
f,u,1849,163,14220,2885,271,843,2454,6453
m,m,1937,16005,1268894,473571,34449,87206,222723,817949
m,m,1966,22781,1591096,687065,44777,115519,297072,1144433
f,f,1919,3299,727671,152237,11500,30344,90443,284524
f,m,1853,1511,128793,18345,1709,5689,14584,40327
m,u,1859,543,38893,9331,821,2387,5862,18401
f,u,1815,219,29581,5144,493,1525,4194,11356
u,f,1950,3062,53026,16134,1278,3333,3166,23911
u,u,1960,15366,365575,89149,5569,18565,18053,131336
u,u,1974,13178,254276,66537,4672,14233,13289,98731
f,u,1826,56,7596,1402,81,540,1330,3353
u,f,2002,6673,100025,35302,2433,7022,8112,52869
m,m,1947,21111,1678393,602612,42489,103784,279988,1028873
f,f,1862,864,183082,29364,2781,7797,23266,63208
u,f,1836,384,9188,1304,119,484,307,2214
u,u,1972,14579,241863,67548,4946,14538,14573,101605
m,m,1825,2726,373251,45717,3560,13824,37298,100399
f,u,1810,69,4563,1026,83,348,1123,2580
u,m,1860,1554,58307,4945,351,1585,1056,7937
f,u,1975,9105,731761,308787,24364,64407,182011,579569
u,f,1871,1040,35722,3833,363,1068,868,6132
m,f,1961,6317,459722,188173,13817,33591,84987,320568
m,m,1961,20930,1777394,662305,43784,112217,287262,1105568
f,u,1819,96,9259,2868,211,995,2482,6556
u,u,1934,6306,157782,34221,2653,8765,7323,52962
u,u,1808,36,347,76,11,23,20,130
u,u,1845,270,9368,941,70,292,149,1452
m,u,1975,25010,1495493,594623,44902,119772,299757,1059054
u,u,1917,1299,53748,6696,510,1623,1272,10101
u,u,2003,14832,295832,88866,6088,17596,19875,132425
u,f,1949,2674,50819,14756,1114,2965,2788,21623
f,u,1888,373,56987,9495,830,2195,7387,19907
m,u,1840,309,26614,4279,349,1384,3825,9837
m,m,1963,19668,1284036,557516,38187,96833,246236,938772
u,m,1927,8945,179486,34564,2662,9149,7841,54216
u,f,2008,7009,93002,44142,3147,9082,10525,66896
u,m,1965,12668,218322,64083,4096,12736,12281,93196
f,u,1942,3314,367728,131844,9776,24452,70879,236951
m,m,1935,16891,1455592,524511,38691,98708,255066,916976
f,f,2003,7333,726714,384058,25749,63386,210678,683871
f,u,1835,123,22331,2497,198,782,1965,5442
u,f,1900,1855,47142,7330,654,2000,1653,11637
f,u,1957,6963,743759,286456,22378,55783,153850,518467
m,f,1821,398,61076,13952,1002,4144,12422,31520
u,m,1823,1000,24759,2298,204,843,511,3856
u,m,1836,1175,41697,3303,288,1123,682,5396
u,u,1953,11873,271018,65473,4391,14327,13507,97698
m,m,1964,20954,1636206,654225,43087,109732,288607,1095651
m,u,1977,27365,1602589,662223,47741,127298,325738,1163000
m,f,1939,4414,394674,140882,10132,26414,66806,244234
m,f,1951,6821,546735,206398,15278,37780,92927,352383
m,f,1896,6334,802706,134387,11859,32733,79552,258531
f,f,1802,149,23211,4420,468,1715,4354,10957
f,m,1810,236,7992,6343,711,2261,5775,15090
m,f,1947,6956,590497,215910,15673,38032,96280,365895
u,f,1997,8672,139731,40874,2615,7522,10092,61103
m,f,1861,1227,105020,20409,2001,5471,13219,41100
u,f,2001,6656,141043,40569,2638,8048,9702,60957
u,u,1906,776,14826,2519,227,748,599,4093
u,f,1843,508,18598,1661,133,580,360,2734
f,u,1831,105,13257,1972,253,575,1932,4732
f,f,1883,2247,454574,96007,9211,21933,68234,195385
u,f,1807,237,2665,734,42,343,133,1252
u,m,1990,13613,209482,66498,4111,12663,13714,96986
f,u,1808,139,17309,2072,216,822,1485,4595
f,m,1849,764,89155,14930,1487,4641,12337,33395
m,m,1889,6660,799549,133664,11353,33020,78731,256768
u,f,1822,228,5700,833,77,301,272,1483
f,u,1964,6692,587372,236382,17953,46610,134608,435553
u,f,1883,1726,50073,6636,665,1978,1706,10985
f,m,1914,4088,862439,172902,12990,36673,99587,322152
m,f,1914,5080,662980,145194,10918,31901,76106,264119
f,u,1836,111,7886,1541,186,481,1523,3731
u,m,1996,12458,181757,58349,3786,11507,13695,87337
f,f,1985,5271,507762,251525,16902,40945,131274,440646
f,m,1969,8282,575326,251332,18083,45813,129520,444748
f,m,1888,2361,444222,79126,6688,20348,56906,163068
m,m,1929,15355,1237448,455784,33453,93327,227640,810204
u,u,1941,6666,111150,29852,2149,7601,7102,46704
f,m,1837,621,102907,14016,1234,4446,12844,32540
u,u,1894,287,3443,758,71,230,125,1184
u,f,1930,2219,43622,14976,1175,3416,3293,22860
m,u,1892,977,79616,13645,1239,3575,8151,26610
u,m,2007,12138,197958,66363,4113,12992,13312,96780
u,f,1823,276,9522,1035,86,312,190,1623
f,f,1926,1990,257460,96415,7321,19386,58245,181367
m,m,1886,5332,672683,120016,10063,29845,70719,230643
m,m,2013,21,2072,1008,132,354,448,1942
f,m,1920,4240,673064,165896,13419,35007,94073,308395
m,u,1999,24308,1268885,590290,40461,110915,299224,1040890
u,m,1942,6792,103324,32744,2218,6909,6250,48121
u,m,1969,14338,225503,60667,4333,12560,11516,89076
f,u,1954,5155,564613,200238,14578,36999,108521,360336
f,u,1863,326,69882,11286,1057,2767,8797,23907
u,m,1948,7493,176005,38868,2641,7814,7988,57311
u,u,1956,12330,311205,72147,4782,15451,14863,107243
f,m,2012,0,0,0,0,0,0,0
u,u,1839,184,5544,474,40,214,100,828
u,f,1835,977,18619,1928,194,626,539,3287
f,f,1904,1768,354365,63647,4750,13702,41149,123248
u,u,1965,18426,319078,95665,6512,20637,19354,142168
m,f,2000,13668,826668,430044,31148,78217,194950,734359
u,u,1826,97,9532,489,49,135,160,833
u,m,1869,2064,46328,4980,489,1494,1172,8135
u,m,1832,881,45011,3218,236,1071,777,5302
f,f,1880,1843,361451,90257,7926,21940,67917,188040
m,m,1922,16249,1929529,481667,34953,99239,239369,855228
m,m,1970,25484,1661766,717181,46969,121649,315625,1201424
m,m,1821,760,83974,13234,997,3696,10449,28376
f,f,1815,315,95989,13410,1093,4171,11865,30539
m,m,1806,303,32940,4928,436,1537,4265,11166
f,f,1945,3001,427969,148846,10353,25186,78840,263225
u,f,1992,6593,142458,45427,2732,8357,11086,67602
u,f,1942,2466,40328,11768,978,2846,2680,18272
m,f,1919,5178,706999,159464,12361,34493,79652,285970
u,u,2011,65,485,63,2,16,3,84
f,f,1807,206,27869,8288,523,3132,9283,21226
u,u,1843,199,11347,1072,86,404,230,1792
m,u,1834,520,61846,7746,596,2217,6286,16845
f,f,1847,628,175459,29853,2673,8686,26373,67585
f,m,1953,5386,555634,207142,14374,37061,100522,359099
m,m,1880,6040,908871,139654,11195,37706,88112,276667
f,m,1899,4854,756821,135119,11032,32795,92251,271197
m,u,1966,22474,1718131,586952,43013,112617,297626,1040208
u,f,1882,1585,61953,8446,717,2449,2133,13745
m,m,1840,3646,499887,69976,5408,20886,49672,145942
f,u,1846,190,39354,4422,439,1604,4237,10702
f,m,1860,1039,165364,26791,2399,7885,23196,60271
f,f,1975,3675,343143,150529,11053,26442,77958,265982
m,m,1913,12946,1993907,384998,26691,85801,189927,687417
f,u,1905,761,108187,20320,1624,5255,13742,40941
f,f,2014,0,0,0,0,0,0,0
u,f,1989,5543,142722,36985,2180,6827,8668,54660
u,f,1953,2903,45946,14065,1050,3070,3420,21605
u,u,1895,665,15947,2522,213,774,600,4109
f,u,1827,176,29042,3958,439,1204,2884,8485
m,f,1840,1140,186845,27086,2349,8764,21150,59349
f,m,1802,11,477,213,23,110,332,678
m,m,1980,22129,1619609,642163,40587,108961,281234,1072945
u,m,1804,362,9317,737,89,291,134,1251
m,f,1929,4519,358452,132484,10733,27392,69637,240246
m,m,1977,19112,1271951,568126,35925,94372,257183,955606
m,m,1824,1482,131257,22825,1820,7199,18506,50350
f,u,1919,773,119635,27487,2427,6005,17602,53521
m,u,1967,32170,2067349,792252,58922,163937,409377,1424488
f,m,1896,4209,584355,108342,9478,26724,71832,216376
f,f,2001,7350,776985,376995,24128,60365,198535,660023
m,u,1820,141,18077,2703,229,756,2037,5725
m,u,1862,533,78166,13178,1381,3483,8174,26216
f,u,1947,6765,789975,272479,20992,49575,148339,491385
u,m,1995,12767,231890,70465,4455,13160,14966,103046
u,f,1987,5005,108963,31680,1922,5717,7659,46978
u,u,1973,14783,262950,78411,5651,16703,16756,117521
f,u,1828,172,29670,4359,343,1143,2738,8583
u,f,1878,1526,44368,5360,529,1590,1543,9022
u,u,1848,169,9762,542,44,250,116,952
u,f,1920,2722,55652,10566,917,2763,2707,16953
f,f,1824,433,133540,20672,1738,6460,17848,46718
u,f,1980,4645,70664,25841,1844,5158,6080,38923
f,m,1977,5612,377343,179487,12626,31940,90813,314866
m,f,2005,14731,938279,456691,31874,82287,211353,782205
u,u,1836,68,4239,431,38,178,73,720
m,u,2002,22664,1256862,527187,37262,98080,265946,928475
f,u,1979,9183,752972,297208,23182,58684,171640,550714
u,f,1974,3529,63419,21901,1436,3862,4975,32174
u,f,1994,7148,161040,52229,3109,8955,12550,76843
f,f,1874,1468,336770,62479,5724,15688,43126,127017
f,m,1909,3009,483185,99208,7819,23137,60297,190461
u,u,1992,22967,476995,132267,9689,27680,30282,199918
f,u,1802,53,7833,1100,81,394,1224,2799
u,m,1868,1638,43538,5348,486,1733,1115,8682
f,m,1890,2661,477872,86907,7775,21947,60506,177135
u,u,1888,357,10610,1359,148,400,401,2308
m,f,1808,96,11323,1301,130,486,1420,3337
f,f,1841,1075,176169,31855,3001,10462,28920,74238
m,f,1881,3109,344541,80838,7173,20226,45480,153717
m,u,1886,799,83271,13691,1367,3741,9524,28323
u,f,1819,164,1145,599,74,241,122,1036
m,u,2013,0,0,0,0,0,0,0
f,f,1817,368,95189,13103,1092,4201,13980,32376
u,u,1866,111,2101,261,25,99,72,457
m,m,1999,22457,1470937,657325,40854,113152,299941,1111272
f,m,1979,6372,531355,215859,14944,38143,113522,382468
m,m,1988,23363,1501468,656698,41994,111168,302281,1112141
m,f,1945,5767,584872,188348,13170,32738,82334,316590
m,m,1814,21,205,149,9,37,85,280
f,m,1833,633,89077,10962,976,3607,10308,25853
u,u,1852,197,4564,584,41,164,64,853
u,u,1835,121,3315,263,29,102,100,494
m,f,1975,7123,405776,175496,13388,33483,77533,299900
f,u,1956,6772,693826,256194,20018,51325,141815,469352
u,u,1893,409,6977,1220,126,366,319,2031
u,m,2010,147,292,593,38,75,73,779
f,u,1953,6425,518674,191231,13921,35844,102605,343601
u,f,1870,987,29618,3188,295,941,901,5325
f,m,1943,3889,396746,137556,9987,24846,66392,238781
u,f,1905,1379,38705,6293,467,1520,1316,9596
f,u,1868,558,125450,24110,1848,5977,16909,48844
u,f,1826,351,18769,1509,126,462,522,2619
f,f,1929,2450,293912,117674,9319,22060,68686,217739
u,m,1993,12355,136905,50034,3704,10550,11656,75944
m,m,1851,2326,359641,52152,3809,16376,32794,105131
f,u,1986,10324,716487,336579,24337,64313,192712,617941
m,f,1806,201,23549,5789,385,1862,4929,12965
u,f,1867,1458,37555,3805,376,1208,901,6290
m,m,1933,13361,1203143,414309,29633,79693,200461,724096
u,f,1868,1004,30900,3100,314,957,746,5117
u,m,1929,8514,123914,34385,2575,8706,6871,52537
m,f,1805,75,9695,2420,161,759,2077,5417
u,f,1932,1812,30945,8226,683,1865,2353,13127
f,m,2010,134,6187,5674,387,826,2493,9380
u,f,1943,2634,66099,16261,980,3509,3450,24200
u,m,2005,12625,165632,64981,4610,13411,14375,97377
u,m,1847,751,39805,3015,249,1083,505,4852
u,f,1818,292,9779,1223,119,429,433,2204
m,f,1924,2625,180880,72275,5610,15377,37626,130888
f,f,1959,2689,316170,126759,8447,20627,62253,218086
f,f,1844,690,172610,23179,2128,6823,19438,51568
f,f,1956,2993,411025,153625,11524,26153,76404,267706
f,u,2000,10323,741366,314516,22187,60227,186039,582969
m,m,1927,16793,1449876,470043,34925,98503,247194,850665
f,u,2012,0,0,0,0,0,0,0
f,f,1930,2564,307891,139521,10478,26705,79643,256347
f,u,1894,323,45921,12177,897,2433,8389,23896
f,u,1895,346,50618,10891,932,2603,8570,22996
m,u,1972,22593,1544325,564254,41043,109818,280441,995556
u,f,1955,3107,49370,14241,1041,3042,2881,21205
m,m,1823,1954,227936,29721,2642,9313,23786,65462
m,u,1813,25,3094,836,101,250,588,1775
u,u,1962,18228,385884,99778,6333,22848,19200,148159
u,u,1821,74,398,81,8,46,24,159
m,m,1879,2463,317753,60575,5577,15522,37526,119200
f,m,1966,7033,551834,226196,16150,40898,116494,399738
f,u,1803,80,10322,1313,122,495,1389,3319
m,f,1804,179,8470,3836,400,1074,2710,8020
u,u,1919,1295,24207,4628,406,1150,1052,7236
m,m,1962,18922,1528360,593368,39475,101121,247443,981407
m,f,2010,175,10773,4723,334,818,1856,7731
f,f,1971,2911,222384,102391,7657,17531,51749,179328
f,f,1987,5422,597482,286864,19879,46698,151199,504640
u,u,1863,182,3572,582,72,150,126,930
f,m,1980,6535,512904,213465,14930,37661,104473,370529
u,u,1891,489,10657,1904,163,511,432,3010
f,u,1900,509,55085,11836,1043,2618,7508,23005
u,f,1829,337,11888,941,99,339,286,1665
u,m,1973,11180,181528,50801,3366,9834,10481,74482
u,f,1899,2332,75338,9916,910,2725,2494,16045
u,u,1985,19167,342675,110820,7482,22469,24664,165435
f,u,1856,345,80266,8901,779,2565,7596,19841
f,u,1881,263,33383,5835,596,1549,4029,12009
m,m,1971,22545,1476996,611679,40312,103568,275025,1030584
u,u,1987,17795,299213,97498,6736,20205,21190,145629
f,m,1866,1498,270733,40623,3744,11590,31508,87465
u,u,1979,17279,367549,94761,6350,19355,19771,140237
m,u,1980,24843,1398626,621614,43200,113200,307945,1085959
m,u,1872,914,89420,20830,1991,5267,13708,41796
u,f,1903,1542,40342,6655,506,1633,1483,10277
m,f,1979,9017,595036,257187,18270,46879,113369,435705
m,m,1967,23024,1757563,740804,48591,128065,325304,1242764
m,u,1984,24980,1184561,562501,41321,105866,281223,990911
u,u,1892,606,15303,1975,172,596,649,3392
m,u,1936,14925,1062394,351570,27447,69059,185616,633692
u,f,1824,301,13949,1082,88,431,177,1778
u,f,1977,3103,68953,22109,1410,3969,4292,31780
m,m,1842,2161,440927,63893,4281,18551,42846,129571
u,u,1816,76,2033,132,19,52,36,239
u,m,1888,4307,148930,15229,1284,4459,3379,24351
m,u,1873,614,77539,13872,1247,3565,8229,26913
u,f,1965,3239,69862,19407,1292,3861,3905,28465
u,f,1923,1195,23086,6000,516,1500,1314,9330
f,u,1873,292,56155,9973,985,2620,7037,20615
m,f,1982,9851,528941,244812,18464,46114,107512,416902
u,f,1895,2263,62097,7838,738,2299,1816,12691
m,f,1857,2000,289362,53251,5198,14332,35589,108370
f,m,2007,7713,530031,291940,19528,49694,151745,512907
m,u,1918,1497,145589,32907,2253,7398,15955,58513
f,u,1936,5184,503685,175075,13867,32934,99201,321077
f,u,1825,158,16148,3466,397,970,3065,7898
m,f,1942,5532,447847,157516,12328,29890,72461,272195
f,m,1911,4180,744349,145960,11440,32232,87157,276789
m,m,2006,24833,1353573,692761,44310,118185,318491,1173747
f,f,1974,3085,304369,132770,9944,23536,69038,235288
f,f,1928,2181,293889,108446,7556,19359,61863,197224
f,m,1844,1066,230336,29187,2098,10292,24219,65796
f,m,1818,196,28378,3216,276,938,2660,7090
f,u,1992,13311,833600,435125,32180,80580,252427,800312
m,m,1945,13840,1063927,391251,26920,64931,168008,651110
m,u,1968,36730,2024182,809880,60150,171433,411116,1452579
f,f,1900,2217,380468,74196,6297,16797,47708,144998
f,f,1804,129,7032,3311,341,957,2417,7026
m,f,2007,15932,946357,501828,34854,90713,231624,859019
f,u,1978,7977,644359,285042,20622,53602,159876,519142
m,u,1856,609,88144,9828,887,2843,7150,20708
m,m,1863,2489,325438,50850,4490,14213,33550,103103
m,u,1933,12847,1108923,360534,27143,73075,182295,643047
f,u,1973,7081,429559,229581,18349,45800,129041,422771
f,f,1923,1250,144362,58173,4746,11586,33440,107945
u,u,1918,853,17677,3212,231,824,537,4804
u,f,1938,2619,41540,13695,985,2987,2954,20621
u,m,1914,5169,137164,19515,1634,5476,4280,30905
u,u,2005,17794,301051,97328,6940,19832,23299,147399
f,u,2002,8299,614894,260361,18721,49463,157822,486367
f,m,1929,5113,519682,189971,14645,39250,108956,352822
u,m,1852,2210,76981,6016,597,2140,1072,9825
f,f,1988,6217,600861,290405,18409,45714,150409,504937
u,m,1813,68,518,120,10,63,37,230
u,f,1817,288,12983,1673,114,591,471,2849
u,f,1810,455,10556,1644,82,576,431,2733
u,m,1893,6678,295412,34430,2238,10286,4966,51920
u,u,2010,818,7292,3949,297,819,657,5722
m,u,1803,149,16096,2956,232,1113,2297,6598
u,f,1846,409,12512,1335,127,471,309,2242
u,u,1995,18310,319489,98017,7004,20997,22630,148648
u,m,1982,11014,222557,64364,4029,12209,13233,93835
f,m,1981,6655,518845,238830,16770,41738,120369,417707
u,u,1859,243,4126,511,62,172,112,857
u,m,1854,1702,41360,3528,354,1223,841,5946
u,f,1861,579,13670,1709,192,589,425,2915
m,f,1888,3381,399679,83586,7811,20811,48570,160778
u,f,1970,4623,70159,21636,1666,4751,4873,32926
u,m,1947,10511,178083,48086,3526,10291,9873,71776
m,u,1940,9721,888483,301060,20777,55480,142196,519513
f,u,1920,1051,161029,34089,2786,7193,20987,65055
m,u,1969,34233,2196024,796613,60377,160293,418796,1436079
m,u,2012,0,0,0,0,0,0,0
u,f,1831,279,18765,959,90,379,264,1692
u,m,2000,14648,250921,75838,5202,15493,16166,112699
m,u,1911,1970,205553,39206,2944,9160,19581,70891
u,m,1919,5316,130349,23345,1838,5607,4963,35753
f,m,1948,5059,509617,189476,13931,34527,97159,335093
f,f,1805,69,11527,3375,210,1354,3296,8235
f,m,1898,3904,713803,122873,9798,30862,80879,244412
m,f,1893,5230,696073,137180,12348,33121,78041,260690
f,f,1982,5364,551635,259420,17162,41432,126837,444851
u,f,1914,2685,77934,12097,893,2894,2638,18522
m,f,1813,562,86363,12784,1001,4065,12437,30287
m,f,1852,1655,273871,40058,3370,10195,27507,81130
f,m,1994,7057,477625,223751,14995,38937,115904,393587
m,f,1898,4792,592610,111879,9696,26367,64859,212801
m,f,1965,5377,475619,195936,13848,35687,84752,330223
f,u,2005,9522,577886,309336,22623,58491,182331,572781
m,m,1855,3075,421225,59643,4468,16431,38570,119112
m,u,1905,1945,225715,39731,3171,9865,22794,75561
u,f,1889,2106,80991,9063,817,2674,2234,14788
u,f,1978,3805,73110,23466,1479,4372,5636,34953
u,u,1881,268,4332,572,74,184,95,925
f,m,2000,8667,649796,298528,19699,51793,155460,525480
f,m,1989,7473,541336,262138,17853,46015,133894,459900
f,f,1924,1506,197451,71497,5694,14025,43175,134391
u,u,1986,18039,349061,100112,6852,19919,21198,148081
m,f,2003,14070,876094,432811,31771,79199,197255,741036
m,u,1879,1205,199267,33934,3058,8785,20899,66676
m,u,1953,19163,1317664,458861,33109,89017,229395,810382
f,m,1924,4714,559940,193999,14661,37981,109882,356523
m,u,1962,25425,1942953,686269,48006,137410,346861,1218546
u,m,1961,11292,187206,55388,3551,10691,10854,80484
m,m,1984,21469,1488304,641948,41763,110801,287999,1082511
u,u,1975,17662,354063,91159,6552,19602,17983,135296
m,u,1914,1859,219858,36532,3105,9046,21033,69716
u,f,1939,2044,32964,9181,717,2107,1996,14001
f,u,1886,374,55125,10872,1131,2839,9157,23999
u,m,1959,11078,232540,59825,3575,11418,11082,85900
f,u,1845,165,22973,2561,214,739,2106,5620
u,u,1830,705,33920,2301,195,889,538,3923
u,m,1802,14,714,38,6,15,3,62
u,m,1924,7156,109782,24811,1909,6132,5869,38721
m,u,1884,336,46216,9506,1021,2483,4820,17830
u,u,1976,18706,306165,85981,6315,18495,18015,128806
f,f,1818,442,76395,14142,1376,4675,12883,33076
f,f,1898,2616,578594,96238,8420,22455,68163,195276
m,u,1954,16051,1329238,485495,34066,91858,241296,852715
m,m,1931,11266,997409,349938,23942,66881,168534,609295
m,u,1931,14944,1179276,403530,30553,83630,212304,730017
u,m,1939,5531,116919,26272,1905,5820,5601,39598
f,f,1832,726,141228,20393,1995,6142,17502,46032
f,m,1882,1922,271240,60282,5483,15113,42775,123653
f,m,1917,3098,483519,112505,8846,24209,66721,212281
m,f,1836,1074,168288,24144,2089,7358,17473,51064
u,m,1851,1093,44860,3836,309,1459,520,6124
m,f,1859,1316,189716,30607,2780,8336,21716,63439
u,u,1998,18769,322406,97459,7182,20723,24355,149719
u,f,1961,3734,83341,27527,1837,5334,5231,39929
m,m,1856,3706,461204,68765,5607,19407,44068,137847
f,f,1890,2219,438224,87003,8063,20554,61741,177361
u,f,1902,1235,38444,6305,508,1544,1470,9827
f,m,1869,1316,189637,34205,3417,9136,24187,70945
f,m,1883,3932,541750,104197,10104,27611,74398,216310
m,u,1828,349,32670,4594,474,1367,3004,9439
m,u,1817,136,8562,1882,194,706,1692,4474
m,m,1801,541,48842,7714,675,2731,6195,17315
m,m,1867,2877,447927,70959,6528,18587,43057,139131
m,f,1973,7904,425325,187259,14675,35920,86007,323861
m,f,1926,3392,271796,91510,7022,18433,45648,162613
m,m,1865,3589,542872,81035,6775,22357,51578,161745
u,u,1914,1058,34914,4475,334,1175,995,6979
m,u,1909,1462,171384,34668,2702,7812,19467,64649
f,m,1939,3004,295096,105831,8019,19928,56225,190003
f,u,1820,47,12482,1651,146,530,1023,3350
m,m,1969,26666,1822402,748388,50122,127850,325666,1252026
f,u,1838,89,14606,1929,175,580,1867,4551
u,u,1991,22585,380429,120126,8269,24819,26087,179301
f,u,1967,10295,883998,354808,27646,72049,210386,664889
m,m,1847,1737,262742,37656,2855,11270,25639,77420
m,f,1853,1573,248949,37555,3596,9925,25646,76722
m,m,1912,12894,1779447,369280,27028,82146,183289,661743
m,m,1890,7949,1197726,185407,15314,46573,114029,361323
f,m,2005,7796,553721,278120,18168,48198,145005,489491
u,f,2012,0,0,0,0,0,0,0
f,u,1884,180,26870,6663,688,1644,3990,12985
m,m,1833,2252,304036,32796,2677,9686,25857,71016
f,m,1885,1811,271981,50986,4311,13115,34990,103402
u,m,1901,3753,107296,14117,1017,4271,2625,22030
m,m,1885,6181,672624,115978,10106,29869,70629,226582
f,f,1922,4324,850820,192424,15234,39703,113530,360891
u,u,1861,222,4693,783,69,225,134,1211
u,u,1938,7785,116908,37002,2650,8220,7409,55281
u,f,1859,491,10162,1686,110,438,346,2580
u,u,1923,12485,309921,62830,4113,15062,13192,95197
u,m,1970,12712,195992,64544,4143,12171,13170,94028
u,u,1846,227,12569,707,56,266,94,1123
u,u,1952,11619,315732,68852,4550,15136,14085,102623
u,u,2000,15769,244102,84177,5732,16974,19624,126507
f,m,1889,2269,337682,67973,5917,16809,46042,136741
f,u,1977,9662,785312,324773,24183,62516,179406,590878
m,f,1868,2433,343634,67403,5903,17015,39732,130053
u,m,1943,7121,120883,30455,2215,6833,5186,44689
f,u,1834,130,22784,2610,194,751,2486,6041
u,m,1838,640,23024,1953,160,655,365,3133
u,u,1877,185,5776,387,62,125,82,656
m,f,1937,5516,478356,167459,12508,31209,77617,288793
f,f,1908,2713,606639,115851,9121,23859,71046,219877
f,m,1942,3484,309035,122370,9052,23520,63123,218065
u,f,1945,2412,68710,17127,1189,3352,3411,25079
f,m,1970,7792,543603,238981,17314,44389,122344,423028
m,u,1985,27437,1420259,641420,46891,119205,315292,1122808
m,f,1864,2550,386988,60096,5258,16046,36508,117908
f,m,1975,5704,416795,182772,12329,33400,93202,321703
f,u,1897,232,29230,5634,507,1325,3720,11186
m,f,1995,13065,817124,386881,27003,70334,175201,659419
u,m,1859,2631,102486,7780,648,2271,1550,12249
f,m,1806,112,9816,1784,158,581,2129,4652
u,u,1822,258,4958,512,37,233,217,999
m,u,1844,264,27326,5861,398,1749,4364,12372
m,u,1910,1727,203943,40842,2977,8774,21800,74393
u,u,1947,10911,226765,58202,4059,12584,11273,86118
u,f,1909,2119,60142,8808,739,2121,1888,13556
m,f,1845,2673,335305,47144,4373,15831,43845,111193
m,f,1993,11344,666977,314388,21750,57404,146942,540484
u,u,1908,1372,21714,4008,450,1036,835,6329
m,m,2012,0,0,0,0,0,0,0
f,f,1902,1567,326041,59563,4796,13030,37556,114945
f,f,1869,1576,361707,67474,6367,15757,49079,138677
f,u,1850,16,1484,278,26,70,251,625
m,f,1890,4275,560976,108931,9996,27168,64917,211012
u,u,1961,17343,338736,95360,7011,20481,20296,143148
u,u,1858,793,19996,2063,178,637,606,3484
m,m,2003,25022,1575454,693313,44504,117258,312907,1167982
f,m,1944,3016,282618,105612,7617,19439,53346,186014
m,f,1862,1334,189616,32400,2922,9041,18558,62921
u,m,1975,10464,170409,51052,3268,9813,9877,74010
u,f,1973,3951,51544,17333,1345,3771,4129,26578
f,m,1903,2354,364413,70263,5287,16623,45751,137924
f,f,1854,1148,261308,46837,4310,12400,36520,100067
u,m,1840,1856,38220,3935,341,1557,703,6536
u,f,1865,1202,41646,4197,417,1309,1118,7041
m,m,1905,7110,1012498,191342,13881,43524,102545,351292
f,u,1974,7014,454669,223318,17595,46430,134697,422040
f,u,1859,293,34259,7911,672,2069,6441,17093
u,m,1915,4982,148401,21401,1562,5793,4520,33276
f,u,1821,112,19897,5214,411,1681,5451,12757
u,m,1881,2180,63774,8344,715,2492,1710,13261
u,u,1802,20,664,39,1,19,11,70
f,u,1892,359,45863,10387,933,2626,8544,22490
f,f,1921,3076,760190,168282,12621,34642,96328,311873
u,m,1899,10661,363767,44970,3712,12286,11226,72194
m,f,1823,576,80948,15378,1372,5051,12039,33840
u,m,1871,2028,56688,6727,613,2223,1164,10727
f,m,1834,646,154450,15442,1291,4779,14212,35724
u,m,1862,1522,42228,5053,447,1398,790,7688
f,m,2003,7838,616044,284561,18861,49008,148388,500818
m,u,1836,187,14629,2502,262,783,2475,6022
u,u,1939,6774,189324,35777,2536,7774,7670,53757
m,m,1953,17385,1625531,580968,38360,101017,259481,979826
m,m,1843,1874,295467,38015,2761,11080,27867,79723
u,m,1977,9754,175368,51971,3346,9561,10364,75242
u,m,1964,12425,210753,62879,4334,12599,12186,91998
m,m,1951,17749,1706681,622227,41895,108000,273736,1045858
m,f,1971,6000,334550,150876,11125,26838,66443,255282
u,u,1936,9350,166729,40125,3028,8802,8933,60888
m,m,1875,2844,429864,74354,6399,18884,44568,144205
m,f,1944,5504,486734,163502,12035,30048,77006,282591
m,u,1808,126,13476,1724,175,573,1251,3723
f,f,1884,1996,373221,79641,7624,19018,56967,163250
m,f,1869,2584,352962,61415,5743,15715,36977,119850
m,u,1883,479,49418,7886,803,2121,4992,15802
m,f,1994,14600,896484,427117,28885,77306,195602,728910
u,f,1880,2486,95522,13048,941,3901,3276,21166
u,f,1940,2136,51177,11542,825,2531,2209,17107
f,m,1871,1122,167303,35502,3084,9985,27005,75576
f,f,1876,2021,463530,81434,7431,19348,58371,166584
f,m,1836,772,128576,14018,1207,4353,13258,32836
m,m,1942,13867,1102100,425919,28972,77943,195050,727884
m,f,1917,5084,695463,155427,11940,32773,77050,277190
u,u,1978,17371,384125,99821,6645,20982,21921,149369
u,f,1927,1745,32760,8892,793,2142,2219,14046
f,m,1964,6162,496457,213664,15621,39093,106358,374736
u,u,1889,412,9644,1285,117,355,391,2148
u,m,1884,3172,60760,8891,771,3040,2051,14753
f,m,1855,1004,177987,25866,2231,7983,18902,54982
m,m,1923,13224,1276378,413410,30250,82692,221148,747500
m,f,1964,5940,440980,184066,13197,32631,78512,308406
f,u,1848,185,18323,3227,353,1113,3118,7811
f,f,1845,1226,213734,31464,3130,10558,35594,80746
u,m,1911,5053,131355,19718,1493,5285,4363,30859
f,f,1806,132,20363,5352,437,1901,5549,13239
m,f,1953,6239,549984,206490,14940,37392,89739,348561
m,m,1996,24510,1593874,690003,43564,118425,313353,1165345
u,u,1901,1305,28260,4724,410,1374,1190,7698
u,u,1829,37,639,69,10,31,37,147
f,u,1871,259,43392,7190,736,1743,4802,14471
m,f,1877,2650,333258,63964,6040,15937,39563,125504
m,f,1897,4369,653577,124976,10881,28861,72466,237184
m,f,1887,4344,552765,111665,10373,27654,65740,215432
m,f,1960,6837,603056,217258,15330,38842,91345,362775
u,u,1831,126,5322,289,32,101,49,471
u,u,1886,405,12391,1134,136,381,289,1940
f,f,1893,3144,740678,134932,12322,30744,91220,269218
u,m,1857,2308,92271,8212,683,2854,1608,13357
f,u,1840,87,7872,856,80,323,1064,2323
u,m,1855,1253,37160,3947,280,1189,828,6244
f,m,1947,6247,601533,219433,16459,39402,110644,385938
m,u,1897,709,78912,12420,1020,2950,7393,23783
u,u,1928,10886,181909,46430,3376,12393,9108,71307
m,m,1909,9906,1422217,265781,19089,61189,139183,485242
u,u,1834,289,9064,835,51,250,156,1292
u,u,1943,8045,147000,36653,2426,7878,7108,54065
u,m,1844,2249,69340,5557,503,2109,1016,9185
f,f,1990,6103,491168,265514,18080,43733,139267,466594
f,f,1838,635,139883,17754,1568,5643,17982,42947
u,u,1803,90,760,100,15,36,17,168
m,f,1934,5288,406359,159914,12679,32128,79158,283879
u,m,1837,1139,49394,3694,303,1323,758,6078
m,u,1912,1788,198742,38399,2836,8313,19840,69388
m,f,1817,597,104724,19015,1319,5283,16082,41699
m,u,1810,199,5901,1138,109,408,1033,2688
f,m,1904,2285,347834,69435,5174,16343,42122,133074
u,m,1861,851,25254,2520,224,701,466,3911
m,u,1832,1040,93053,11783,1031,3417,11463,27694
f,u,1910,506,82371,16094,1161,3478,10251,30984
m,u,1826,173,8186,2795,194,1040,2153,6182
m,u,1904,1653,180634,38023,3173,8759,19794,69749
u,u,1970,23229,428465,113970,8155,25000,22782,169907
f,f,1851,771,211170,33000,3026,9485,30162,75673
u,u,1870,185,8867,604,53,159,209,1025
u,f,1888,1503,49549,6684,670,1980,1762,11096
f,u,1985,10154,795280,341471,25804,63239,193572,624086
m,u,2008,14101,711730,362129,26619,69751,181169,639668
u,m,1824,688,15277,1307,112,549,304,2272
f,u,1961,8109,744599,294677,22593,55736,168055,541061
m,u,1849,384,40861,7814,713,2053,5714,16294
f,f,1994,7855,772865,413139,25692,65035,217044,720910
m,f,1849,1074,147230,24486,2038,6950,18911,52385
f,u,1829,87,14410,2625,270,796,1941,5632
m,f,1899,5296,762182,125294,10995,28911,68399,233599
u,u,1820,52,1103,109,13,32,28,182
m,f,1948,6306,577632,197925,14392,36265,86824,335406
f,u,1902,862,140437,26139,1976,5498,17665,51278
f,m,1982,6180,505496,222748,14549,38764,109141,385202
u,f,1944,2477,36180,10074,847,2312,2319,15552
m,f,1969,6653,502632,199262,14072,35898,88289,337521
u,f,1857,736,17206,2166,221,726,513,3626
f,u,1860,455,78043,12835,1099,3642,10718,28294
m,m,1904,7843,948344,182381,13511,42607,95484,333983
u,u,1840,174,5420,498,53,150,87,788
m,m,1959,19219,1654058,597573,38587,100905,267670,1004735
f,f,2008,7579,520349,391736,24988,64226,203015,683965
m,f,1871,2369,354749,62768,5558,15846,38004,122176
u,u,1920,1413,36901,5781,464,1514,1393,9152
f,m,1997,8426,692761,299982,19496,52395,154473,526346
f,f,1853,1145,303522,42494,3723,11294,33943,91454
u,f,1848,363,11853,841,87,311,170,1409
f,f,1882,1753,381751,73109,6603,17818,51134,148664
f,u,1963,6972,625893,229747,17233,45169,132838,424987
m,u,1976,29795,1886278,721339,53330,142937,359028,1276634
